Season,Rank,Team,Games Played,Wins,Losses,Total Points,PPG,Kaggle Name,Kaggle TeamID
2002,1,UConn,39,39,0,3394,87,uconn,3163
2002,2,Duke,35,31,4,2922,83.5,duke,3181
2002,3,Eastern Ky.,31,23,8,2507,80.9,eastern ky.,3184
2002,4,Stanford,35,32,3,2809,80.3,stanford,3390
2002,5,North Carolina,35,26,9,2797,79.9,north carolina,3314
2002,6,Tennessee,34,29,5,2715,79.9,tennessee,3397
2002,7,Minnesota,30,22,8,2390,79.7,minnesota,3278
2002,8,Morehead St.,29,21,8,2303,79.4,morehead st.,3287
2002,9,Canisius,28,12,16,2199,78.5,canisius,3145
2002,10,Richmond,30,14,16,2355,78.5,richmond,3350
2002,11,Oklahoma,36,32,4,2815,78.2,oklahoma,3328
2002,12,Ball St.,32,24,8,2496,78,ball st.,3123
2002,12,Fla. Atlantic,31,17,14,2418,78,fla. atlantic,3194
2002,14,Baylor,33,27,6,2569,77.8,baylor,3124
2002,15,Howard,29,19,10,2250,77.6,howard,3224
2002,16,Iowa St.,33,24,9,2549,77.2,iowa st.,3235
2002,17,Mississippi St.,31,19,12,2390,77.1,mississippi st.,3280
2002,18,Louisiana Tech,30,25,5,2289,76.3,louisiana tech,3256
2002,19,Iowa,29,18,11,2209,76.2,iowa,3234
2002,20,Colorado,34,24,10,2588,76.1,colorado,3160
2002,21,Santa Clara,31,21,10,2358,76.1,santa clara,3365
2002,22,UC Santa Barbara,32,26,6,2427,75.8,uc santa barbara,3364
2002,23,Chattanooga,31,23,8,2344,75.6,chattanooga,3151
2002,24,Holy Cross,31,23,8,2341,75.5,holy cross,3221
2002,25,Kansas St.,34,26,8,2566,75.5,kansas st.,3243
2002,26,Belmont,28,19,9,2113,75.5,belmont,3125
2002,27,Old Dominion,34,28,6,2559,75.3,old dominion,3330
2002,28,FIU,33,27,6,2464,74.7,fiu,3198
2002,29,Illinois,29,15,14,2165,74.7,illinois,3228
2002,30,Cincinnati,32,27,5,2385,74.5,cincinnati,3153
2002,31,Alabama St.,30,23,7,2233,74.4,alabama st.,3106
2002,32,Tennessee Tech,30,22,8,2230,74.3,tennessee tech,3399
2002,33,Arizona,28,14,14,2076,74.1,arizona,3112
2002,34,Washington,31,19,12,2298,74.1,washington,3449
2002,35,Austin Peay,31,19,12,2291,73.9,austin peay,3122
2002,36,Drake,33,25,8,2437,73.8,drake,3179
2002,37,Colgate,31,14,17,2288,73.8,colgate,3159
2002,38,Penn St.,35,23,12,2579,73.7,penn st.,3336
2002,39,Alabama,31,19,12,2284,73.7,alabama,3104
2002,40,Louisville,30,17,13,2208,73.6,louisville,3257
2002,41,Purdue,30,24,6,2207,73.6,purdue,3345
2002,42,Wofford,29,16,13,2133,73.6,wofford,3459
2002,43,Siena,30,23,7,2202,73.4,siena,3373
2002,44,Long Beach St.,29,16,13,2127,73.3,long beach st.,3253
2002,44,Ohio,29,13,16,2127,73.3,ohio,3325
2002,46,North Texas,30,21,9,2192,73.1,north texas,3317
2002,47,South Carolina,32,25,7,2335,73,south carolina,3376
2002,48,LSU,30,18,12,2187,72.9,lsu,3261
2002,49,Green Bay,31,24,7,2259,72.9,green bay,3453
2002,50,Southeast Mo. St.,28,16,12,2037,72.8,southeast mo. st.,3369
2002,51,Pepperdine,31,23,8,2254,72.7,pepperdine,3337
2002,52,BYU,33,24,9,2397,72.6,byu,3140
2002,53,Texas Tech,32,20,12,2324,72.6,texas tech,3403
2002,54,Vanderbilt,37,30,7,2684,72.5,vanderbilt,3435
2002,55,South Fla.,27,14,13,1951,72.3,south fla.,3378
2002,56,Bucknell,31,21,10,2235,72.1,bucknell,3137
2002,57,Arkansas,32,20,12,2304,72,arkansas,3116
2002,58,Middle Tenn.,29,16,13,2087,72,middle tenn.,3292
2002,59,Wichita St.,29,14,15,2085,71.9,wichita st.,3455
2002,60,Western Mich.,31,16,15,2227,71.8,western mich.,3444
2002,61,Miami (OH),30,19,11,2155,71.8,miami (oh),3275
2002,62,Western Ky.,30,16,14,2152,71.7,western ky.,3443
2002,63,Southern California,30,16,14,2151,71.7,southern california,3425
2002,64,Georgia St.,31,21,10,2217,71.5,georgia st.,3209
2002,65,Grambling,28,18,10,2001,71.5,grambling,3212
2002,66,Saint Mary's (CA),29,16,13,2069,71.3,saint mary's (ca),3388
2002,67,Michigan,30,17,13,2140,71.3,michigan,3276
2002,68,ETSU,28,10,18,1997,71.3,etsu,3190
2002,68,Milwaukee,28,20,8,1997,71.3,milwaukee,3454
2002,70,TCU,31,24,7,2210,71.3,tcu,3395
2002,71,Pacific,30,19,11,2136,71.2,pacific,3334
2002,72,Kent St.,31,20,11,2207,71.2,kent st.,3245
2002,72,Colorado St.,31,24,7,2207,71.2,colorado st.,3161
2002,74,Saint Joseph's,32,24,8,2277,71.2,saint joseph's,3386
2002,75,Wisconsin,31,19,12,2204,71.1,wisconsin,3458
2002,76,UNLV,31,23,8,2200,71,unlv,3424
2002,77,Creighton,31,24,7,2199,70.9,creighton,3166
2002,78,Saint Peter's,31,25,6,2198,70.9,saint peter's,3389
2002,79,Georgia Tech,29,15,14,2051,70.7,georgia tech,3210
2002,80,Ohio St.,29,14,15,2050,70.7,ohio st.,3326
2002,81,Texas,32,22,10,2256,70.5,texas,3400
2002,82,Cleveland St.,28,13,15,1973,70.5,cleveland st.,3156
2002,83,Oregon,35,22,13,2464,70.4,oregon,3332
2002,84,Florida,29,18,11,2038,70.3,florida,3196
2002,85,American,27,12,15,1896,70.2,american,3110
2002,86,Ga. Southern,27,13,14,1894,70.1,ga. southern,3204
2002,87,Davidson,28,10,18,1961,70,davidson,3172
2002,88,SFA,30,24,6,2101,70,utsa,3427
2002,89,Furman,29,17,12,2030,70,furman,3202
2002,90,Houston,34,26,8,2379,70,houston,3222
2002,91,Ole Miss,28,11,17,1959,70,ole miss,3279
2002,92,Denver,29,16,13,2027,69.9,denver,3176
2002,92,Fairfield,29,13,16,2027,69.9,fairfield,3193
2002,94,Bradley,28,16,12,1954,69.8,bradley,3133
2002,95,UNCG,31,21,10,2162,69.7,unc,3314
2002,96,Florida St.,28,13,15,1952,69.7,florida st.,3199
2002,97,Gonzaga,29,11,18,2021,69.7,gonzaga,3211
2002,98,Weber St.,31,22,9,2158,69.6,weber st.,3451
2002,99,New Mexico St.,29,13,16,2015,69.5,new mexico st.,3308
2002,100,Tulane,35,24,11,2430,69.4,tulane,3408
2002,100,Mt. St. Mary's,28,12,16,1944,69.4,mt. st. mary's,3291
2002,102,Quinnipiac,27,13,14,1869,69.2,quinnipiac,3346
2002,103,Syracuse,31,18,13,2145,69.2,syracuse,3393
2002,104,VCU,28,14,14,1936,69.1,vcu,3433
2002,105,Evansville,30,15,15,2073,69.1,evansville,3191
2002,106,Idaho St.,27,10,17,1865,69.1,idaho st.,3226
2002,107,Harvard,28,22,6,1933,69,harvard,3217
2002,108,Georgia,30,19,11,2068,68.9,georgia,3208
2002,108,Nebraska,30,14,16,2068,68.9,nebraska,3304
2002,110,DePaul,29,15,14,1994,68.8,depaul,3177
2002,111,Col. of Charleston,28,14,14,1924,68.7,col. of charleston,3158
2002,111,IUPUI,28,11,17,1924,68.7,iupui,3237
2002,113,Appalachian St.,29,10,19,1992,68.7,appalachian st.,3111
2002,114,Toledo,28,17,11,1922,68.6,toledo,3405
2002,115,High Point,28,13,15,1920,68.6,high point,3219
2002,116,Mercer,29,16,13,1983,68.4,mercer,3273
2002,117,Southern U.,31,26,5,2118,68.3,southern u.,3380
2002,118,Duquesne,29,14,15,1978,68.2,duquesne,3182
2002,119,Xavier,31,12,19,2114,68.2,xavier,3462
2002,120,Western Caro.,28,17,11,1909,68.2,western caro.,3441
2002,121,Texas A&M,29,13,16,1977,68.2,texas a&m,3401
2002,122,San Francisco,30,18,12,2044,68.1,san francisco,3362
2002,123,Boston College,31,23,8,2111,68.1,boston college,3130
2002,124,Northern Ariz.,28,17,11,1906,68.1,northern ariz.,3319
2002,125,San Jose St.,28,17,11,1905,68,san jose st.,3363
2002,126,Northwestern St.,29,22,7,1971,68,northwestern st.,3322
2002,126,Montana St.,29,18,11,1971,68,montana st.,3286
2002,128,Marist,28,11,17,1901,67.9,marist,3265
2002,129,Norfolk St.,31,22,9,2102,67.8,norfolk st.,3313
2002,130,Detroit Mercy,30,16,14,2033,67.8,detroit mercy,3178
2002,131,Montana,29,19,10,1964,67.7,montana,3285
2002,132,UT Martin,28,8,20,1896,67.7,ut martin,3404
2002,133,Eastern Mich.,29,18,11,1963,67.7,eastern mich.,3185
2002,134,Dartmouth,27,11,16,1826,67.6,dartmouth,3171
2002,135,Monmouth,28,16,12,1893,67.6,monmouth,3284
2002,136,Fairleigh Dickinson,28,14,14,1890,67.5,fairleigh dickinson,3192
2002,137,William & Mary,29,12,17,1955,67.4,william & mary,3456
2002,138,Indiana St.,28,11,17,1885,67.3,indiana st.,3232
2002,139,Saint Francis (PA),31,19,12,2086,67.3,saint francis (pa),3384
2002,140,Rider,28,7,21,1884,67.3,rider,3351
2002,141,Delaware,30,23,7,2018,67.3,delaware,3174
2002,142,Dayton,28,11,17,1883,67.3,dayton,3173
2002,143,LIU Brooklyn,30,18,12,2017,67.2,liu brooklyn,3254
2002,144,Vermont,32,23,9,2150,67.2,vermont,3436
2002,145,Memphis,28,11,17,1879,67.1,memphis,3272
2002,146,UNI,30,14,16,2013,67.1,uni,3320
2002,147,Niagara,28,9,19,1878,67.1,niagara,3310
2002,148,George Washington,30,21,9,2012,67.1,george washington,3203
2002,149,Indiana,31,17,14,2076,67,indiana,3231
2002,150,Wyoming,28,13,15,1875,67,wyoming,3461
2002,151,UCF,30,17,13,2008,66.9,ucf,3416
2002,152,Auburn,29,16,13,1939,66.9,auburn,3120
2002,153,Pittsburgh,27,8,19,1804,66.8,pittsburgh,3338
2002,154,Yale,27,14,13,1801,66.7,yale,3463
2002,154,Princeton,27,11,16,1801,66.7,princeton,3343
2002,156,Columbia,26,12,14,1734,66.7,columbia,3162
2002,157,Penn,27,12,15,1800,66.7,penn,3335
2002,158,Oklahoma St.,31,16,15,2065,66.6,oklahoma st.,3329
2002,159,Loyola Chicago,29,15,14,1931,66.6,loyola chicago,3260
2002,160,Drexel,29,14,15,1930,66.6,drexel,3180
2002,161,Clemson,29,17,12,1927,66.4,clemson,3155
2002,162,Navy,28,13,15,1859,66.4,navy,3298
2002,163,UC Riverside,29,16,13,1925,66.4,uc riverside,3415
2002,164,Oregon St.,32,17,15,2124,66.4,oregon st.,3333
2002,165,Missouri,29,14,15,1923,66.3,missouri,3281
2002,166,Virginia,30,17,13,1989,66.3,virginia,3438
2002,167,San Diego,28,13,15,1856,66.3,san diego,3360
2002,168,Valparaiso,33,26,7,2186,66.2,valparaiso,3434
2002,169,Miami (FL),31,19,12,2050,66.1,miami (fl),3274
2002,170,Temple,31,20,11,2049,66.1,temple,3396
2002,171,Youngstown St.,28,12,16,1849,66,youngstown st.,3464
2002,172,Arizona St.,34,25,9,2243,66,arizona st.,3113
2002,173,Portland,28,13,15,1846,65.9,portland,3339
2002,174,Virginia Tech,32,21,11,2108,65.9,virginia tech,3439
2002,175,Cornell,27,14,13,1777,65.8,cornell,3165
2002,176,New Mexico,31,22,9,2040,65.8,new mexico,3307
2002,177,Loyola Marymount,28,15,13,1842,65.8,loyola marymount,3258
2002,178,Boston U.,28,17,11,1837,65.6,boston u.,3131
2002,179,Southern Utah,27,10,17,1767,65.4,southern utah,3381
2002,180,Notre Dame,30,20,10,1962,65.4,notre dame,3323
2002,181,Hampton,31,17,14,2027,65.4,hampton,3214
2002,182,Manhattan,29,18,11,1896,65.4,manhattan,3264
2002,183,Jacksonville St.,27,8,19,1763,65.3,jacksonville st.,3240
2002,184,Liberty,31,23,8,2022,65.2,liberty,3251
2002,185,Western Ill.,28,16,12,1826,65.2,western ill.,3442
2002,186,Utah,27,15,12,1758,65.1,utah,3428
2002,187,Loyola Maryland,29,12,17,1884,65,loyola maryland,3259
2002,188,Cal Poly,28,11,17,1816,64.9,cal poly,3142
2002,189,Stetson,29,14,15,1880,64.8,stetson,3391
2002,190,Arkansas St.,28,12,16,1815,64.8,arkansas st.,3117
2002,191,Murray St.,28,11,17,1814,64.8,murray st.,3293
2002,192,Sacred Heart,29,18,11,1877,64.7,sacred heart,3357
2002,193,Lehigh,28,12,16,1811,64.7,lehigh,3250
2002,194,West Virginia,28,14,14,1808,64.6,west virginia,3452
2002,195,Oakland,31,17,14,1999,64.5,oakland,3324
2002,196,Michigan St.,32,19,13,2063,64.5,michigan st.,3277
2002,197,UAB,28,12,16,1805,64.5,uab,3412
2002,198,Tulsa,30,17,13,1933,64.4,tulsa,3409
2002,199,Kentucky,29,9,20,1868,64.4,kentucky,3246
2002,200,Maine,28,16,12,1802,64.4,maine,3263
2002,201,Army West Point,29,11,18,1864,64.3,armstrong,3118
2002,202,Campbell,28,13,15,1799,64.3,campbell,3144
2002,203,Elon,28,15,13,1794,64.1,elon,3189
2002,204,Winthrop,29,11,18,1858,64.1,winthrop,3457
2002,205,Wagner,29,14,15,1852,63.9,wagner,3447
2002,206,Rice,30,21,9,1914,63.8,rice,3349
2002,207,New Hampshire,29,16,13,1850,63.8,new hampshire,3306
2002,208,Bowling Green,28,9,19,1784,63.7,bowling green,3132
2002,209,Alabama A&M,28,11,17,1783,63.7,alabama a&m,3105
2002,210,Troy,28,11,17,1779,63.5,troy,3407
2002,211,Hawaii,31,23,8,1969,63.5,hawaii,3218
2002,212,Southeastern La.,29,11,18,1840,63.4,southeastern la.,3368
2002,213,NC State,29,14,15,1835,63.3,nc state,3301
2002,214,Missouri St.,29,16,13,1834,63.2,missouri st.,3283
2002,215,Maryland,30,13,17,1895,63.2,maryland,3268
2002,216,St. Bonaventure,28,13,15,1768,63.1,st. bonaventure,3382
2002,217,Oral Roberts,29,13,16,1831,63.1,oral roberts,3331
2002,218,New Orleans,29,11,18,1827,63,new orleans,3309
2002,218,Texas Southern,28,11,17,1764,63,texas southern,3411
2002,220,James Madison,28,16,12,1763,63,james madison,3241
2002,221,SMU,30,12,18,1887,62.9,smu,3374
2002,222,Georgetown,28,12,16,1758,62.8,georgetown,3207
2002,223,South Carolina St.,29,18,11,1820,62.8,south carolina st.,3354
2002,224,Rhode Island,28,15,13,1755,62.7,rhode island,3348
2002,225,George Mason,31,17,14,1943,62.7,george mason,3206
2002,226,Northeastern,28,6,22,1753,62.6,northeastern,3318
2002,227,Alcorn,27,15,12,1690,62.6,alcorn,3108
2002,228,St. Francis Brooklyn,27,5,22,1684,62.4,st. francis brooklyn,3383
2002,229,Fresno St.,29,9,20,1808,62.3,fresno st.,3201
2002,230,South Ala.,28,17,11,1745,62.3,south ala.,3375
2002,231,Robert Morris,25,3,22,1558,62.3,robert morris,3352
2002,232,UTRGV,28,7,21,1744,62.3,utrgv,3410
2002,233,Bethune-Cookman,27,14,13,1681,62.3,bethune-cookman,3126
2002,234,La Salle,28,6,22,1742,62.2,la salle,3247
2002,235,Hartford,31,16,15,1926,62.1,hartford,3216
2002,236,Ill.-Chicago,30,15,15,1858,61.9,ill.-chicago,3227
2002,237,Central Mich.,28,10,18,1731,61.8,central mich.,3141
2002,238,Tennessee St.,25,3,22,1545,61.8,tennessee st.,3398
2002,239,Binghamton,28,19,9,1730,61.8,binghamton,3127
2002,239,Providence,28,13,15,1730,61.8,providence,3344
2002,241,Stony Brook,30,16,14,1850,61.7,stony brook,3392
2002,242,UNCW,30,16,14,1847,61.6,unc,3314
2002,243,Eastern Ill.,28,7,21,1723,61.5,eastern ill.,3183
2002,244,Northern Ill.,30,17,13,1843,61.4,northern ill.,3296
2002,245,Butler,29,3,26,1777,61.3,butler,3139
2002,246,Jackson St.,29,16,13,1773,61.1,jackson st.,3238
2002,247,Centenary (LA),28,9,19,1710,61.1,centenary (la),3147
2002,248,UT Arlington,29,14,15,1770,61,ut arlington,3426
2002,249,Marquette,28,14,14,1707,61,marquette,3266
2002,250,Portland St.,29,11,18,1767,60.9,portland st.,3340
2002,251,Villanova,31,20,11,1887,60.9,villanova,3437
2002,252,Wake Forest,28,12,16,1701,60.8,wake forest,3448
2002,252,Charleston So.,28,12,16,1701,60.8,charleston so.,3149
2002,254,Florida A&M,29,11,18,1759,60.7,florida a&m,3197
2002,255,UMES,29,12,17,1758,60.6,umes,3271
2002,256,CSUN,26,2,24,1574,60.5,lsu,3261
2002,257,UC Irvine,28,8,20,1695,60.5,uc irvine,3414
2002,258,Wright St.,28,6,22,1691,60.4,wright st.,3460
2002,259,UTEP,28,3,25,1686,60.2,utep,3431
2002,260,La.-Monroe,27,9,18,1619,60,la.-monroe,3419
2002,261,Charlotte,29,16,13,1738,59.9,charlotte,3150
2002,262,Texas St.,28,12,16,1677,59.9,texas st.,3402
2002,263,Boise St.,30,10,20,1793,59.8,boise st.,3129
2002,264,Southern Ill.,27,6,21,1613,59.7,southern ill.,3356
2002,265,Radford,27,11,16,1612,59.7,radford,3347
2002,266,Marshall,28,9,19,1670,59.6,marshall,3267
2002,267,Iona,29,8,21,1729,59.6,iona,3233
2002,268,Nevada,28,9,19,1666,59.5,nevada,3305
2002,269,Idaho,28,11,17,1665,59.5,idaho,3225
2002,270,Hofstra,28,9,19,1663,59.4,hofstra,3220
2002,270,Coppin St.,28,14,14,1663,59.4,coppin st.,3164
2002,272,Northwestern,28,4,24,1662,59.4,northwestern,3321
2002,273,Seton Hall,29,15,14,1721,59.3,seton hall,3371
2002,274,UMBC,27,12,15,1599,59.2,umbc,3420
2002,275,Saint Louis,29,14,15,1716,59.2,saint louis,3387
2002,276,Louisiana,28,7,21,1656,59.1,se louisiana,3368
2002,277,UCLA,29,9,20,1712,59,ucla,3417
2002,278,Sam Houston St.,27,3,24,1593,59,sam houston st.,3358
2002,279,Eastern Wash.,29,11,18,1709,58.9,eastern wash.,3186
2002,280,San Diego St.,28,10,18,1648,58.9,san diego st.,3361
2002,281,Lafayette,28,3,25,1643,58.7,lafayette,3248
2002,282,Little Rock,27,8,19,1584,58.7,little rock,3114
2002,283,Chicago St.,29,11,18,1700,58.6,chicago st.,3152
2002,284,Brown,27,5,22,1576,58.4,brown,3135
2002,285,Illinois St.,27,7,20,1574,58.3,illinois st.,3229
2002,286,Albany (NY),27,4,23,1571,58.2,albany (ny),3107
2002,286,Jacksonville,27,4,23,1571,58.2,jacksonville,3239
2002,288,Samford,27,3,24,1570,58.1,samford,3359
2002,289,Kansas,30,5,25,1744,58.1,kansas,3242
2002,290,East Carolina,27,6,21,1567,58,east carolina,3187
2002,291,Coastal Caro.,29,11,18,1670,57.6,coastal caro.,3157
2002,292,Massachusetts,30,12,18,1726,57.5,massachusetts,3269
2002,293,Air Force,28,4,24,1608,57.4,air force,3102
2002,294,Fordham,29,6,23,1654,57,fordham,3200
2002,295,Nicholls St.,27,11,16,1533,56.8,nicholls st.,3311
2002,296,California,28,7,21,1589,56.8,california,3143
2002,297,Washington St.,29,2,27,1629,56.2,washington st.,3450
2002,298,UMKC,28,7,21,1571,56.1,umkc,3282
2002,299,Southern Miss.,28,11,17,1570,56.1,southern miss.,3379
2002,300,Cal St. Fullerton,28,4,24,1560,55.7,cal st. fullerton,3168
2002,301,Rutgers,29,9,20,1613,55.6,rutgers,3353
2002,302,McNeese,27,6,21,1497,55.4,mcneese st,3270
2002,303,Akron,28,1,27,1551,55.4,akron,3103
2002,304,Lamar University,27,8,19,1482,54.9,american university,3110
2002,305,Buffalo,28,9,19,1534,54.8,buffalo,3138
2002,306,UNC Asheville,28,1,27,1532,54.7,unc asheville,3421
2002,307,Morris Brown,28,3,25,1506,53.8,morris brown,3289
2002,308,Delaware St.,28,9,19,1487,53.1,delaware st.,3175
2002,309,Mississippi Val.,27,2,25,1424,52.7,mississippi val.,3290
2002,310,N.C. A&T,29,4,25,1515,52.2,n.c. a&t,3299
2002,311,UTSA,28,16,12,1455,52,utsa,3427
2002,312,Savannah St.,28,4,24,1445,51.6,savannah st.,3366
2002,313,St. John's (NY),27,3,24,1363,50.5,st. john's (ny),3385
2002,314,Ark.-Pine Bluff,25,6,19,1253,50.1,ark.-pine bluff,3115
2002,315,Morgan St.,28,1,27,1394,49.8,morgan st.,3288
2002,316,Central Conn. St.,27,4,23,1305,48.3,central conn. st.,3148
2002,317,Sacramento St.,27,0,27,1292,47.9,sacramento st.,3170
2002,318,Towson,28,2,26,1324,47.3,towson,3406
2002,319,Prairie View,27,6,21,1200,44.4,prairie view,3341
2003,1,Indiana St.,31,22,9,2480,80,indiana st.,3232
2003,2,Tennessee,38,33,5,3037,79.9,tennessee,3397
2003,3,Ball St.,31,21,10,2474,79.8,ball st.,3123
2003,4,Duke,37,35,2,2922,79,duke,3181
2003,5,Western Mich.,32,20,12,2523,78.8,western mich.,3444
2003,6,Louisiana Tech,34,31,3,2666,78.4,louisiana tech,3256
2003,7,Eastern Ky.,29,18,11,2268,78.2,eastern ky.,3184
2003,8,Green Bay,32,28,4,2502,78.2,green bay,3453
2003,9,Minnesota,31,25,6,2412,77.8,minnesota,3278
2003,10,Georgia,31,21,10,2381,76.8,georgia,3208
2003,11,Penn St.,35,26,9,2680,76.6,penn st.,3336
2003,12,LSU,34,30,4,2593,76.3,lsu,3261
2003,13,North Carolina,34,28,6,2580,75.9,north carolina,3314
2003,14,Southeast Mo. St.,30,19,11,2271,75.7,southeast mo. st.,3369
2003,15,Washington,30,22,8,2267,75.6,washington,3449
2003,16,Baylor,35,24,11,2644,75.5,baylor,3124
2003,17,Morehead St.,28,16,12,2108,75.3,morehead st.,3287
2003,18,UConn,38,37,1,2841,74.8,uconn,3163
2003,19,Miami (FL),31,18,13,2315,74.7,miami (fl),3274
2003,20,Kansas St.,34,29,5,2539,74.7,kansas st.,3243
2003,21,Mississippi St.,32,24,8,2389,74.7,mississippi st.,3280
2003,22,Miami (OH),29,17,12,2163,74.6,miami (oh),3275
2003,23,Texas,35,29,6,2609,74.5,texas,3400
2003,24,Texas Tech,35,29,6,2605,74.4,texas tech,3403
2003,25,Austin Peay,31,27,4,2300,74.2,austin peay,3122
2003,26,Creighton,33,24,9,2446,74.1,creighton,3166
2003,27,UC Santa Barbara,32,27,5,2368,74,uc santa barbara,3364
2003,27,Vanderbilt,32,22,10,2368,74,vanderbilt,3435
2003,27,South Carolina,31,23,8,2294,74,south carolina,3376
2003,30,Jacksonville St.,29,15,14,2136,73.7,jacksonville st.,3240
2003,30,Louisville,29,15,14,2136,73.7,louisville,3257
2003,32,Cleveland St.,29,11,18,2132,73.5,cleveland st.,3156
2003,33,Purdue,35,29,6,2566,73.3,purdue,3345
2003,34,UCLA,29,18,11,2117,73,ucla,3417
2003,35,Chattanooga,31,26,5,2262,73,chattanooga,3151
2003,36,Northwestern St.,28,17,11,2039,72.8,northwestern st.,3322
2003,37,Arizona,31,22,9,2255,72.7,arizona,3112
2003,38,Howard,29,12,17,2105,72.6,howard,3224
2003,39,Bucknell,28,13,15,2029,72.5,bucknell,3137
2003,39,Fla. Atlantic,28,14,14,2029,72.5,fla. atlantic,3194
2003,41,Montana St.,30,21,9,2166,72.2,montana st.,3286
2003,42,Houston,28,15,13,2021,72.2,houston,3222
2003,43,Iowa,33,18,15,2376,72,iowa,3234
2003,43,George Washington,32,25,7,2304,72,george washington,3203
2003,45,Pepperdine,30,22,8,2159,72,pepperdine,3337
2003,46,Western Ky.,31,22,9,2229,71.9,western ky.,3443
2003,47,DePaul,32,22,10,2290,71.6,depaul,3177
2003,48,Charlotte,30,21,9,2143,71.4,charlotte,3150
2003,49,Canisius,30,16,14,2141,71.4,canisius,3145
2003,50,Illinois,29,17,12,2067,71.3,illinois,3228
2003,51,Wichita St.,28,14,14,1991,71.1,wichita st.,3455
2003,52,Niagara,29,20,9,2062,71.1,niagara,3310
2003,53,Siena,33,25,8,2344,71,siena,3373
2003,54,Cincinnati,31,23,8,2196,70.8,cincinnati,3153
2003,55,Mt. St. Mary's,28,10,18,1981,70.8,mt. st. mary's,3291
2003,56,Stanford,32,27,5,2263,70.7,stanford,3390
2003,57,Missouri St.,31,18,13,2189,70.6,missouri st.,3283
2003,58,Boston College,31,22,9,2183,70.4,boston college,3130
2003,59,UNI,30,18,12,2112,70.4,uni,3320
2003,60,Harvard,27,22,5,1897,70.3,harvard,3217
2003,61,Penn,27,15,12,1893,70.1,penn,3335
2003,62,Liberty,30,26,4,2103,70.1,liberty,3251
2003,63,Pittsburgh,28,12,16,1960,70,pittsburgh,3338
2003,64,FIU,30,19,11,2093,69.8,fiu,3198
2003,65,Ill.-Chicago,28,17,11,1949,69.6,ill.-chicago,3227
2003,66,Maine,31,25,6,2153,69.5,maine,3263
2003,67,UT Martin,29,13,16,2009,69.3,ut martin,3404
2003,68,Santa Clara,31,20,11,2143,69.1,santa clara,3365
2003,69,East Carolina,28,12,16,1926,68.8,east carolina,3187
2003,70,Old Dominion,32,21,11,2201,68.8,old dominion,3330
2003,71,Michigan St.,29,17,12,1992,68.7,michigan st.,3277
2003,72,Richmond,32,21,11,2195,68.6,richmond,3350
2003,73,Rider,28,8,20,1920,68.6,rider,3351
2003,74,Ga. Southern,30,20,10,2054,68.5,ga. southern,3204
2003,75,Jackson St.,29,23,6,1983,68.4,jackson st.,3238
2003,76,Middle Tenn.,30,18,12,2051,68.4,middle tenn.,3292
2003,77,Western Caro.,28,21,7,1913,68.3,western caro.,3441
2003,78,Georgia Tech,31,20,11,2117,68.3,georgia tech,3210
2003,79,Quinnipiac,28,18,10,1911,68.3,quinnipiac,3346
2003,80,Hampton,32,23,9,2182,68.2,hampton,3214
2003,81,Grambling,30,20,10,2045,68.2,grambling,3212
2003,82,Marquette,30,16,14,2043,68.1,marquette,3266
2003,83,Vermont,29,21,8,1972,68,vermont,3436
2003,83,James Madison,29,17,12,1972,68,james madison,3241
2003,85,Xavier,30,20,10,2039,68,xavier,3462
2003,86,Ohio St.,32,22,10,2174,67.9,ohio st.,3326
2003,87,Holy Cross,32,24,8,2173,67.9,holy cross,3221
2003,88,Fort Wayne,28,9,19,1899,67.8,iupu-fort wayne,3236
2003,89,Alcorn,30,18,12,2033,67.8,alcorn,3108
2003,90,New Mexico St.,28,16,12,1897,67.8,new mexico st.,3308
2003,91,Colorado,32,24,8,2166,67.7,colorado,3160
2003,92,TCU,34,20,14,2300,67.6,tcu,3395
2003,93,Arkansas,33,22,11,2231,67.6,arkansas,3116
2003,94,Tulane,29,19,10,1960,67.6,tulane,3408
2003,95,West Virginia,28,15,13,1891,67.5,west virginia,3452
2003,96,Southern U.,25,17,8,1688,67.5,southern u.,3380
2003,97,Missouri,31,17,14,2092,67.5,missouri,3281
2003,98,UMES,29,12,17,1954,67.4,umes,3271
2003,99,Maryland,28,10,18,1886,67.4,maryland,3268
2003,100,Belmont,29,19,10,1952,67.3,belmont,3125
2003,101,Rutgers,29,21,8,1951,67.3,rutgers,3353
2003,102,Col. of Charleston,29,10,19,1948,67.2,col. of charleston,3158
2003,103,Bradley,28,13,15,1879,67.1,bradley,3133
2003,104,Western Ill.,30,21,9,2012,67.1,western ill.,3442
2003,105,Milwaukee,28,15,13,1877,67,milwaukee,3454
2003,106,Auburn,34,23,11,2279,67,auburn,3120
2003,107,ETSU,28,9,19,1876,67,etsu,3190
2003,107,Evansville,27,11,16,1809,67,evansville,3191
2003,109,Florida A&M,29,16,13,1942,67,florida a&m,3197
2003,110,Furman,29,16,13,1940,66.9,furman,3202
2003,111,Navy,28,16,12,1872,66.9,navy,3298
2003,112,Oklahoma,32,19,13,2139,66.8,oklahoma,3328
2003,113,Southern California,31,14,17,2071,66.8,southern california,3425
2003,114,Toledo,30,20,10,2004,66.8,toledo,3405
2003,115,New Mexico,33,24,9,2204,66.8,new mexico,3307
2003,116,Wyoming,30,18,12,2002,66.7,wyoming,3461
2003,117,Tennessee Tech,29,12,17,1934,66.7,tennessee tech,3399
2003,117,Kent St.,29,16,13,1934,66.7,kent st.,3245
2003,119,UNCW,28,22,6,1867,66.7,unc,3314
2003,120,Dartmouth,27,15,12,1800,66.7,dartmouth,3171
2003,121,Yale,27,6,21,1798,66.6,yale,3463
2003,122,Colorado St.,34,21,13,2262,66.5,colorado st.,3161
2003,123,Appalachian St.,28,9,19,1862,66.5,appalachian st.,3111
2003,124,Lehigh,27,12,15,1795,66.5,lehigh,3250
2003,125,Brown,27,15,12,1794,66.4,brown,3135
2003,126,Tennessee St.,26,4,22,1727,66.4,tennessee st.,3398
2003,127,Eastern Mich.,29,13,16,1925,66.4,eastern mich.,3185
2003,128,Saint Francis (PA),31,23,8,2056,66.3,saint francis (pa),3384
2003,129,BYU,31,19,12,2055,66.3,byu,3140
2003,130,Davidson,30,15,15,1986,66.2,davidson,3172
2003,131,Arkansas St.,30,12,18,1985,66.2,arkansas st.,3117
2003,132,Northern Ariz.,28,13,15,1852,66.1,northern ariz.,3319
2003,133,Oral Roberts,28,18,10,1849,66,oral roberts,3331
2003,134,UTEP,29,10,19,1914,66,utep,3431
2003,134,George Mason,26,14,12,1716,66,george mason,3206
2003,136,Coastal Caro.,28,13,15,1846,65.9,coastal caro.,3157
2003,136,Oregon,28,12,16,1846,65.9,oregon,3332
2003,136,San Jose St.,28,13,15,1846,65.9,san jose st.,3363
2003,139,UNLV,29,17,12,1909,65.8,unlv,3424
2003,140,Kentucky,27,11,16,1777,65.8,kentucky,3246
2003,141,Saint Louis,31,17,14,2040,65.8,saint louis,3387
2003,142,UC Irvine,29,17,12,1906,65.7,uc irvine,3414
2003,143,Tulsa,30,14,16,1971,65.7,tulsa,3409
2003,144,Georgetown,29,15,14,1904,65.7,georgetown,3207
2003,145,Utah,31,24,7,2035,65.6,utah,3428
2003,146,Wake Forest,28,13,15,1838,65.6,wake forest,3448
2003,147,Gonzaga,30,18,12,1968,65.6,gonzaga,3211
2003,148,Long Beach St.,29,14,15,1900,65.5,long beach st.,3253
2003,148,Michigan,29,13,16,1900,65.5,michigan,3276
2003,150,Syracuse,28,10,18,1834,65.5,syracuse,3393
2003,150,Princeton,28,9,19,1834,65.5,princeton,3343
2003,152,Notre Dame,32,21,11,2092,65.4,notre dame,3323
2003,153,Fresno St.,34,21,13,2221,65.3,fresno st.,3201
2003,154,Clemson,29,14,15,1893,65.3,clemson,3155
2003,155,UCF,30,19,11,1958,65.3,ucf,3416
2003,155,Montana,30,20,10,1958,65.3,montana,3285
2003,157,North Texas,28,12,16,1827,65.3,north texas,3317
2003,157,Charleston So.,28,13,15,1827,65.3,charleston so.,3149
2003,159,Delaware St.,30,20,10,1956,65.2,delaware st.,3175
2003,160,Wright St.,28,11,17,1824,65.1,wright st.,3460
2003,161,Buffalo,29,18,11,1889,65.1,buffalo,3138
2003,162,American,29,18,11,1888,65.1,american,3110
2003,163,Florida St.,30,17,13,1952,65.1,florida st.,3199
2003,164,Georgia St.,31,20,11,2015,65,georgia st.,3209
2003,164,Iowa St.,28,12,16,1820,65,iowa st.,3235
2003,166,La.-Monroe,29,15,14,1883,64.9,la.-monroe,3419
2003,167,Dayton,28,14,14,1818,64.9,dayton,3173
2003,168,SMU,31,16,15,2012,64.9,smu,3374
2003,169,Memphis,28,13,15,1817,64.9,memphis,3272
2003,170,Centenary (LA),28,8,20,1815,64.8,centenary (la),3147
2003,170,Wagner,28,15,13,1815,64.8,wagner,3447
2003,172,Army West Point,31,15,16,2009,64.8,armstrong,3118
2003,173,Bowling Green,28,12,16,1810,64.6,bowling green,3132
2003,174,Youngstown St.,28,6,22,1808,64.6,youngstown st.,3464
2003,175,Loyola Chicago,29,12,17,1870,64.5,loyola chicago,3260
2003,176,Rice,28,15,13,1805,64.5,rice,3349
2003,177,Sacred Heart,28,18,10,1804,64.4,sacred heart,3357
2003,178,Boston U.,31,16,15,1997,64.4,boston u.,3131
2003,179,Colgate,27,9,18,1738,64.4,colgate,3159
2003,180,Hofstra,29,8,21,1866,64.3,hofstra,3220
2003,181,Oakland,29,13,16,1865,64.3,oakland,3324
2003,182,Portland,28,11,17,1800,64.3,portland,3339
2003,183,La Salle,29,15,14,1863,64.2,la salle,3247
2003,184,Virginia Tech,32,22,10,2055,64.2,virginia tech,3439
2003,185,Florida,28,9,19,1798,64.2,florida,3196
2003,186,Mercer,28,12,16,1797,64.2,mercer,3273
2003,187,Ole Miss,28,12,16,1796,64.1,ole miss,3279
2003,188,Weber St.,30,21,9,1923,64.1,weber st.,3451
2003,189,Alabama St.,31,20,11,1984,64,alabama st.,3106
2003,190,South Ala.,30,19,11,1919,64,south ala.,3375
2003,191,Eastern Wash.,29,17,12,1853,63.9,eastern wash.,3186
2003,191,Fairfield,29,12,17,1853,63.9,fairfield,3193
2003,193,UMKC,28,14,14,1789,63.9,umkc,3282
2003,194,Valparaiso,31,18,13,1979,63.8,valparaiso,3434
2003,195,South Carolina St.,29,10,19,1851,63.8,south carolina st.,3354
2003,196,Cal Poly,27,10,17,1720,63.7,cal poly,3142
2003,197,Northeastern,28,8,20,1782,63.6,northeastern,3318
2003,198,Campbell,28,9,19,1780,63.6,campbell,3144
2003,199,Arizona St.,30,16,14,1907,63.6,arizona st.,3113
2003,200,Detroit Mercy,30,10,20,1904,63.5,detroit mercy,3178
2003,201,Troy,28,16,12,1773,63.3,troy,3407
2003,201,Northern Ill.,28,12,16,1773,63.3,northern ill.,3296
2003,203,Texas St.,32,18,14,2026,63.3,texas st.,3402
2003,204,Gardner-Webb,27,5,22,1709,63.3,gardner-webb,3205
2003,205,Idaho St.,26,6,20,1644,63.2,idaho st.,3226
2003,206,Saint Peter's,28,14,14,1770,63.2,saint peter's,3389
2003,207,Marshall,29,12,17,1832,63.2,marshall,3267
2003,207,Bethune-Cookman,29,15,14,1832,63.2,bethune-cookman,3126
2003,209,Southern Ill.,27,7,20,1705,63.1,southern ill.,3356
2003,210,Ohio,28,9,19,1767,63.1,ohio,3325
2003,211,Alabama,28,13,15,1765,63,alabama,3104
2003,212,Virginia,31,17,14,1954,63,virginia,3438
2003,213,Fairleigh Dickinson,27,7,20,1700,63,fairleigh dickinson,3192
2003,214,Drake,28,16,12,1762,62.9,drake,3179
2003,215,UNCG,27,14,13,1698,62.9,unc,3314
2003,216,NC State,28,11,17,1760,62.9,nc state,3301
2003,217,Manhattan,30,20,10,1885,62.8,manhattan,3264
2003,218,Pacific,30,16,14,1883,62.8,pacific,3334
2003,219,Eastern Ill.,28,6,22,1757,62.8,eastern ill.,3183
2003,220,San Diego,30,13,17,1882,62.7,san diego,3360
2003,221,SFA,28,15,13,1756,62.7,utsa,3427
2003,222,Denver,30,12,18,1877,62.6,denver,3176
2003,223,Elon,29,19,10,1814,62.6,elon,3189
2003,224,Saint Mary's (CA),28,11,17,1751,62.5,saint mary's (ca),3388
2003,225,Butler,29,6,23,1813,62.5,butler,3139
2003,226,Norfolk St.,28,8,20,1750,62.5,norfolk st.,3313
2003,227,Monmouth,29,18,11,1812,62.5,monmouth,3284
2003,228,Villanova,34,28,6,2122,62.4,villanova,3437
2003,229,Nevada,29,10,19,1807,62.3,nevada,3305
2003,230,Winthrop,28,10,18,1743,62.3,winthrop,3457
2003,231,Southern Utah,27,9,18,1680,62.2,southern utah,3381
2003,232,Loyola Maryland,28,11,17,1742,62.2,loyola maryland,3259
2003,232,Massachusetts,28,14,14,1742,62.2,massachusetts,3269
2003,234,Duquesne,29,15,14,1804,62.2,duquesne,3182
2003,235,William & Mary,28,8,20,1737,62,william & mary,3456
2003,236,Indiana,28,13,15,1736,62,indiana,3231
2003,237,High Point,30,18,12,1852,61.7,high point,3219
2003,238,Murray St.,28,8,20,1728,61.7,murray st.,3293
2003,239,Columbia,27,11,16,1666,61.7,columbia,3162
2003,240,VCU,29,11,18,1788,61.7,vcu,3433
2003,241,IUPUI,28,9,19,1718,61.4,iupui,3237
2003,242,Albany (NY),27,9,18,1656,61.3,albany (ny),3107
2003,243,New Hampshire,29,13,16,1776,61.2,new hampshire,3306
2003,244,Temple,29,14,15,1775,61.2,temple,3396
2003,245,A&M-Corpus Christi,27,15,12,1652,61.2,a&m-corpus chris,3394
2003,246,Portland St.,28,13,15,1713,61.2,portland st.,3340
2003,247,Saint Joseph's,30,19,11,1835,61.2,saint joseph's,3386
2003,248,Stetson,27,6,21,1650,61.1,stetson,3391
2003,249,Fordham,30,14,16,1830,61,fordham,3200
2003,249,UT Arlington,28,15,13,1708,61,ut arlington,3426
2003,251,Chicago St.,29,13,16,1767,60.9,chicago st.,3152
2003,252,UC Riverside,28,8,20,1706,60.9,uc riverside,3415
2003,252,Lafayette,28,3,25,1706,60.9,lafayette,3248
2003,254,New Orleans,28,12,16,1705,60.9,new orleans,3309
2003,255,Cornell,27,10,17,1638,60.7,cornell,3165
2003,256,Radford,27,9,18,1637,60.6,radford,3347
2003,257,Providence,27,9,18,1634,60.5,providence,3344
2003,257,South Fla.,27,7,20,1634,60.5,south fla.,3378
2003,259,Texas A&M,28,10,18,1685,60.2,texas a&m,3401
2003,260,Cal St. Fullerton,28,7,21,1682,60.1,cal st. fullerton,3168
2003,261,Oregon St.,30,15,15,1801,60,oregon st.,3333
2003,262,Wofford,28,4,24,1679,60,wofford,3459
2003,263,Marist,29,13,16,1738,59.9,marist,3265
2003,264,Hawaii,30,16,14,1797,59.9,hawaii,3218
2003,265,Little Rock,28,5,23,1675,59.8,little rock,3114
2003,266,UAB,27,8,19,1615,59.8,uab,3412
2003,266,Sam Houston St.,27,7,20,1615,59.8,sam houston st.,3358
2003,268,San Francisco,29,12,17,1733,59.8,san francisco,3362
2003,269,Delaware,31,22,9,1852,59.7,delaware,3174
2003,270,Boise St.,30,10,20,1786,59.5,boise st.,3129
2003,271,Kansas,29,11,18,1726,59.5,kansas,3242
2003,272,Stony Brook,28,9,19,1665,59.5,stony brook,3392
2003,273,Coppin St.,29,11,18,1724,59.4,coppin st.,3164
2003,274,Binghamton,27,10,17,1602,59.3,binghamton,3127
2003,275,Illinois St.,28,7,21,1661,59.3,illinois st.,3229
2003,276,Idaho,28,10,18,1660,59.3,idaho,3225
2003,277,Rhode Island,31,16,15,1832,59.1,rhode island,3348
2003,278,Southern Miss.,29,14,15,1713,59.1,southern miss.,3379
2003,279,Drexel,29,12,17,1711,59,drexel,3180
2003,279,Hartford,28,7,21,1652,59,hartford,3216
2003,281,Alabama A&M,28,10,18,1648,58.9,alabama a&m,3105
2003,282,McNeese,26,9,17,1529,58.8,mcneese st,3270
2003,283,Central Mich.,28,11,17,1646,58.8,central mich.,3141
2003,284,Loyola Marymount,29,14,15,1702,58.7,loyola marymount,3258
2003,285,Seton Hall,29,14,15,1687,58.2,seton hall,3371
2003,286,UTSA,29,18,11,1686,58.1,utsa,3427
2003,287,Wisconsin,28,7,21,1622,57.9,wisconsin,3458
2003,288,Air Force,28,7,21,1621,57.9,air force,3102
2003,289,Mississippi Val.,28,9,19,1618,57.8,mississippi val.,3290
2003,290,St. Bonaventure,28,6,22,1614,57.6,st. bonaventure,3382
2003,291,California,29,10,19,1671,57.6,california,3143
2003,292,Oklahoma St.,29,8,21,1670,57.6,oklahoma st.,3329
2003,293,Nebraska,28,8,20,1603,57.3,nebraska,3304
2003,294,St. Francis Brooklyn,27,2,25,1538,57,st. francis brooklyn,3383
2003,295,N.C. A&T,28,7,21,1593,56.9,n.c. a&t,3299
2003,296,LIU Brooklyn,30,15,15,1679,56,liu brooklyn,3254
2003,297,St. John's (NY),27,8,19,1511,56,st. john's (ny),3385
2003,298,UTRGV,28,7,21,1561,55.8,utrgv,3410
2003,299,Robert Morris,27,1,26,1504,55.7,robert morris,3352
2003,300,Washington St.,28,2,26,1555,55.5,washington st.,3450
2003,301,UMBC,30,14,16,1665,55.5,umbc,3420
2003,302,San Diego St.,27,9,18,1498,55.5,san diego st.,3361
2003,303,CSUN,27,3,24,1497,55.4,lsu,3261
2003,304,Central Conn. St.,28,8,20,1550,55.4,central conn. st.,3148
2003,305,Northwestern,28,8,20,1547,55.3,northwestern,3321
2003,306,Iona,28,1,27,1539,55,iona,3233
2003,307,Texas Southern,27,5,22,1483,54.9,texas southern,3411
2003,308,Sacramento St.,27,3,24,1479,54.8,sacramento st.,3170
2003,309,Ark.-Pine Bluff,27,4,23,1470,54.4,ark.-pine bluff,3115
2003,310,Nicholls St.,27,9,18,1456,53.9,nicholls st.,3311
2003,311,Prairie View,25,9,16,1341,53.6,prairie view,3341
2003,312,Southeastern La.,27,7,20,1448,53.6,southeastern la.,3368
2003,313,Jacksonville,27,6,21,1445,53.5,jacksonville,3239
2003,313,Samford,27,7,20,1445,53.5,samford,3359
2003,315,Akron,28,2,26,1491,53.3,akron,3103
2003,316,UNC Asheville,28,3,25,1476,52.7,unc asheville,3421
2003,317,Louisiana,27,8,19,1408,52.1,se louisiana,3368
2003,318,Savannah St.,28,6,22,1412,50.4,savannah st.,3366
2003,319,Lamar University,27,3,24,1335,49.4,american university,3110
2003,320,Morgan St.,28,1,27,1331,47.5,morgan st.,3288
2003,321,Towson,28,3,25,1309,46.8,towson,3406
2004,1,DePaul,30,23,7,2531,84.4,depaul,3177
2004,2,Louisiana Tech,32,29,3,2639,82.5,louisiana tech,3256
2004,3,Duke,34,30,4,2785,81.9,duke,3181
2004,4,TCU,32,25,7,2498,78.1,tcu,3395
2004,5,Missouri St.,32,28,4,2486,77.7,missouri st.,3283
2004,6,Miami (OH),31,22,9,2391,77.1,miami (oh),3275
2004,7,Baylor,35,26,9,2696,77,baylor,3124
2004,8,UConn,35,31,4,2642,75.5,uconn,3163
2004,9,Kansas St.,31,25,6,2340,75.5,kansas st.,3243
2004,10,Harvard,27,16,11,2015,74.6,harvard,3217
2004,11,Idaho St.,29,20,9,2157,74.4,idaho st.,3226
2004,12,Tennessee,35,31,4,2603,74.4,tennessee,3397
2004,13,Indiana St.,28,16,12,2079,74.3,indiana st.,3232
2004,14,Saint Francis (PA),31,25,6,2298,74.1,saint francis (pa),3384
2004,15,Georgia,35,25,10,2585,73.9,georgia,3208
2004,16,Miami (FL),29,22,7,2139,73.8,miami (fl),3274
2004,17,Florida,30,19,11,2212,73.7,florida,3196
2004,18,Jacksonville St.,28,18,10,2058,73.5,jacksonville st.,3240
2004,19,Iowa,29,16,13,2129,73.4,iowa,3234
2004,20,Old Dominion,32,25,7,2349,73.4,old dominion,3330
2004,21,LSU,35,27,8,2563,73.2,lsu,3261
2004,22,Northwestern St.,31,24,7,2267,73.1,northwestern st.,3322
2004,23,Eastern Mich.,30,22,8,2193,73.1,eastern mich.,3185
2004,24,Western Mich.,32,19,13,2334,72.9,western mich.,3444
2004,25,North Carolina,31,24,7,2258,72.8,north carolina,3314
2004,26,Chattanooga,32,29,3,2330,72.8,chattanooga,3151
2004,27,Texas,35,30,5,2548,72.8,texas,3400
2004,28,Ball St.,29,13,16,2111,72.8,ball st.,3123
2004,29,Ole Miss,31,17,14,2254,72.7,ole miss,3279
2004,30,Auburn,31,22,9,2252,72.6,auburn,3120
2004,31,Illinois St.,29,16,13,2106,72.6,illinois st.,3229
2004,32,Arizona,33,24,9,2386,72.3,arizona,3112
2004,32,Texas Tech,33,25,8,2386,72.3,texas tech,3403
2004,34,Bowling Green,31,21,10,2233,72,bowling green,3132
2004,35,Canisius,30,19,11,2153,71.8,canisius,3145
2004,36,Minnesota,34,25,9,2432,71.5,minnesota,3278
2004,37,Charlotte,31,17,14,2217,71.5,charlotte,3150
2004,38,Southern Utah,28,18,10,2002,71.5,southern utah,3381
2004,39,Colgate,31,21,10,2213,71.4,colgate,3159
2004,40,Southeast Mo. St.,29,16,13,2070,71.4,southeast mo. st.,3369
2004,41,Tennessee Tech,29,18,11,2069,71.3,tennessee tech,3399
2004,42,Memphis,31,21,10,2209,71.3,memphis,3272
2004,43,Idaho,29,22,7,2060,71,idaho,3225
2004,44,Washington,31,18,13,2198,70.9,washington,3449
2004,45,Missouri,30,17,13,2127,70.9,missouri,3281
2004,46,Western Ky.,34,20,14,2407,70.8,western ky.,3443
2004,47,Oklahoma,33,24,9,2333,70.7,oklahoma,3328
2004,48,Creighton,33,24,9,2329,70.6,creighton,3166
2004,49,Vanderbilt,34,26,8,2398,70.5,vanderbilt,3435
2004,50,Richmond,33,23,10,2327,70.5,richmond,3350
2004,51,Louisville,30,20,10,2111,70.4,louisville,3257
2004,52,Stanford,34,27,7,2392,70.4,stanford,3390
2004,53,Florida St.,30,15,15,2107,70.2,florida st.,3199
2004,54,Boston College,34,27,7,2385,70.1,boston college,3130
2004,55,UNLV,34,26,8,2381,70,unlv,3424
2004,56,Fort Wayne,28,8,20,1955,69.8,iupu-fort wayne,3236
2004,57,Purdue,33,29,4,2304,69.8,purdue,3345
2004,58,Penn St.,34,28,6,2373,69.8,penn st.,3336
2004,59,UC Santa Barbara,34,27,7,2365,69.6,uc santa barbara,3364
2004,60,Fla. Atlantic,28,12,16,1946,69.5,fla. atlantic,3194
2004,61,Colorado,30,22,8,2083,69.4,colorado,3160
2004,62,Penn,28,17,11,1936,69.1,penn,3335
2004,63,Sacred Heart,29,21,8,2004,69.1,sacred heart,3357
2004,63,UMES,29,12,17,2004,69.1,umes,3271
2004,65,Dartmouth,27,15,12,1864,69,dartmouth,3171
2004,66,East Carolina,28,14,14,1933,69,east carolina,3187
2004,67,Quinnipiac,29,18,11,2001,69,quinnipiac,3346
2004,68,Eastern Ky.,30,15,15,2067,68.9,eastern ky.,3184
2004,69,West Virginia,32,21,11,2201,68.8,west virginia,3452
2004,70,Liberty,32,25,7,2197,68.7,liberty,3251
2004,71,Montana,32,27,5,2194,68.6,montana,3285
2004,72,George Mason,29,18,11,1986,68.5,george mason,3206
2004,73,George Washington,30,22,8,2052,68.4,george washington,3203
2004,74,Niagara,28,18,10,1915,68.4,niagara,3310
2004,75,Maryland,31,18,13,2120,68.4,maryland,3268
2004,76,Murray St.,28,13,15,1913,68.3,murray st.,3293
2004,77,Furman,29,18,11,1981,68.3,furman,3202
2004,78,La.-Monroe,29,18,11,1980,68.3,la.-monroe,3419
2004,79,Ohio St.,31,21,10,2116,68.3,ohio st.,3326
2004,80,Belmont,28,16,12,1911,68.3,belmont,3125
2004,81,Arkansas St.,29,19,10,1977,68.2,arkansas st.,3117
2004,82,Houston,32,28,4,2172,67.9,houston,3222
2004,83,Duquesne,29,16,13,1966,67.8,duquesne,3182
2004,84,Arkansas,28,16,12,1896,67.7,arkansas,3116
2004,85,Boston U.,30,19,11,2030,67.7,boston u.,3131
2004,86,Austin Peay,31,23,8,2096,67.6,austin peay,3122
2004,87,NC State,32,17,15,2161,67.5,nc state,3301
2004,88,Southern California,28,15,13,1889,67.5,southern california,3425
2004,89,A&M-Corpus Christi,28,19,9,1887,67.4,a&m-corpus chris,3394
2004,90,Holy Cross,28,13,15,1885,67.3,holy cross,3221
2004,91,South Fla.,29,14,15,1952,67.3,south fla.,3378
2004,92,South Carolina,28,10,18,1879,67.1,south carolina,3376
2004,93,UCLA,30,17,13,2012,67.1,ucla,3417
2004,94,Eastern Ill.,27,8,19,1810,67,eastern ill.,3183
2004,95,UAB,28,9,19,1877,67,uab,3412
2004,96,Montana St.,29,15,14,1944,67,montana st.,3286
2004,97,Middle Tenn.,32,24,8,2144,67,middle tenn.,3292
2004,97,Western Ill.,29,20,9,1943,67,western ill.,3442
2004,99,Cal Poly,28,14,14,1874,66.9,cal poly,3142
2004,100,Grambling,28,13,15,1873,66.9,grambling,3212
2004,101,Green Bay,31,23,8,2072,66.8,green bay,3453
2004,102,Nebraska,30,18,12,2005,66.8,nebraska,3304
2004,103,Mt. St. Mary's,28,9,19,1869,66.8,mt. st. mary's,3291
2004,104,Fairleigh Dickinson,28,13,15,1867,66.7,fairleigh dickinson,3192
2004,105,Tulsa,31,19,12,2065,66.6,tulsa,3409
2004,106,Eastern Wash.,29,13,16,1931,66.6,eastern wash.,3186
2004,106,Kent St.,29,19,10,1931,66.6,kent st.,3245
2004,108,Kentucky,28,11,17,1863,66.5,kentucky,3246
2004,109,Colorado St.,29,17,12,1927,66.4,colorado st.,3161
2004,110,VCU,28,14,14,1859,66.4,vcu,3433
2004,111,Alabama,28,12,16,1858,66.4,alabama,3104
2004,112,Brown,27,16,11,1791,66.3,brown,3135
2004,113,Wichita St.,28,10,18,1856,66.3,wichita st.,3455
2004,114,Rice,32,22,10,2116,66.1,rice,3349
2004,115,Appalachian St.,28,7,21,1851,66.1,appalachian st.,3111
2004,116,Marshall,30,18,12,1978,65.9,marshall,3267
2004,117,Mississippi St.,29,14,15,1910,65.9,mississippi st.,3280
2004,118,Evansville,27,11,16,1778,65.9,evansville,3191
2004,119,Clemson,29,17,12,1909,65.8,clemson,3155
2004,120,Oral Roberts,30,17,13,1973,65.8,oral roberts,3331
2004,121,Illinois,28,10,18,1841,65.8,illinois,3228
2004,122,Portland,29,14,15,1906,65.7,portland,3339
2004,123,Fairfield,29,10,19,1900,65.5,fairfield,3193
2004,124,Cincinnati,31,15,16,2031,65.5,cincinnati,3153
2004,125,Arizona St.,29,17,12,1898,65.4,arizona st.,3113
2004,126,ETSU,27,13,14,1764,65.3,etsu,3190
2004,127,UT Martin,27,11,16,1763,65.3,ut martin,3404
2004,128,Loyola Chicago,28,11,17,1826,65.2,loyola chicago,3260
2004,129,Iowa St.,33,18,15,2152,65.2,iowa st.,3235
2004,130,Vermont,27,14,13,1760,65.2,vermont,3436
2004,131,Alabama St.,28,19,9,1825,65.2,alabama st.,3106
2004,132,UMKC,29,15,14,1890,65.2,umkc,3282
2004,133,Marquette,32,22,10,2085,65.2,marquette,3266
2004,134,Howard,28,11,17,1824,65.1,howard,3224
2004,135,UT Arlington,31,19,12,2017,65.1,ut arlington,3426
2004,136,Pepperdine,30,17,13,1951,65,pepperdine,3337
2004,137,Utah,31,24,7,2016,65,utah,3428
2004,138,Gonzaga,30,18,12,1950,65,gonzaga,3211
2004,138,Ohio,28,13,15,1820,65,ohio,3325
2004,140,Georgia St.,29,18,11,1884,65,georgia st.,3209
2004,141,Bethune-Cookman,28,14,14,1819,65,bethune-cookman,3126
2004,141,Ill.-Chicago,28,11,17,1819,65,ill.-chicago,3227
2004,143,Florida A&M,29,17,12,1882,64.9,florida a&m,3197
2004,144,Bucknell,29,15,14,1881,64.9,bucknell,3137
2004,145,Michigan St.,31,22,9,2010,64.8,michigan st.,3277
2004,146,BYU,29,15,14,1878,64.8,byu,3140
2004,147,California,29,12,17,1876,64.7,california,3143
2004,148,Maine,32,25,7,2070,64.7,maine,3263
2004,149,Oregon St.,32,17,15,2069,64.7,oregon st.,3333
2004,150,Wake Forest,29,12,17,1875,64.7,wake forest,3448
2004,151,Oakland,28,17,11,1808,64.6,oakland,3324
2004,152,Morehead St.,28,10,18,1804,64.4,morehead st.,3287
2004,153,La Salle,28,15,13,1800,64.3,la salle,3247
2004,154,Lipscomb,32,20,12,2057,64.3,lipscomb,3252
2004,155,Butler,29,14,15,1864,64.3,butler,3139
2004,156,Notre Dame,32,21,11,2054,64.2,notre dame,3323
2004,157,Davidson,28,16,12,1796,64.1,davidson,3172
2004,158,UNI,29,12,17,1860,64.1,uni,3320
2004,159,St. John's (NY),28,10,18,1793,64,st. john's (ny),3385
2004,160,Santa Clara,29,9,20,1853,63.9,santa clara,3365
2004,161,Cleveland St.,28,12,16,1789,63.9,cleveland st.,3156
2004,162,SFA,28,9,19,1788,63.9,utsa,3427
2004,163,Virginia,29,13,16,1850,63.8,virginia,3438
2004,164,James Madison,31,13,18,1975,63.7,james madison,3241
2004,165,Bradley,28,9,19,1781,63.6,bradley,3133
2004,166,Xavier,30,17,13,1906,63.5,xavier,3462
2004,167,Virginia Tech,31,23,8,1969,63.5,virginia tech,3439
2004,168,Western Caro.,31,14,17,1966,63.4,western caro.,3441
2004,169,San Jose St.,29,16,13,1839,63.4,san jose st.,3363
2004,169,Delaware,29,19,10,1839,63.4,delaware,3174
2004,171,Saint Louis,27,8,19,1709,63.3,saint louis,3387
2004,172,St. Bonaventure,28,9,19,1772,63.3,st. bonaventure,3382
2004,172,Northern Ill.,28,12,16,1772,63.3,northern ill.,3296
2004,174,Rhode Island,29,16,13,1835,63.3,rhode island,3348
2004,174,Toledo,29,13,16,1835,63.3,toledo,3405
2004,174,Stetson,29,13,16,1835,63.3,stetson,3391
2004,177,Lehigh,29,13,16,1833,63.2,lehigh,3250
2004,177,Georgia Tech,29,14,15,1833,63.2,georgia tech,3210
2004,179,UC Riverside,28,7,21,1769,63.2,uc riverside,3415
2004,179,Stony Brook,28,7,21,1769,63.2,stony brook,3392
2004,181,Navy,30,13,17,1893,63.1,navy,3298
2004,182,Hampton,30,17,13,1891,63,hampton,3214
2004,183,Valparaiso,32,20,12,2017,63,valparaiso,3434
2004,184,Georgetown,28,13,15,1764,63,georgetown,3207
2004,185,Coppin St.,29,18,11,1826,63,coppin st.,3164
2004,186,Hofstra,28,14,14,1763,63,hofstra,3220
2004,187,Milwaukee,29,17,12,1824,62.9,milwaukee,3454
2004,188,Iona,28,7,21,1759,62.8,iona,3233
2004,189,Pacific,29,15,14,1820,62.8,pacific,3334
2004,190,Siena,28,17,11,1755,62.7,siena,3373
2004,191,Monmouth,30,17,13,1880,62.7,monmouth,3284
2004,192,New Orleans,27,10,17,1689,62.6,new orleans,3309
2004,193,Rutgers,33,21,12,2063,62.5,rutgers,3353
2004,194,Rider,28,5,23,1750,62.5,rider,3351
2004,195,William & Mary,29,11,18,1811,62.4,william & mary,3456
2004,195,Indiana,29,12,17,1811,62.4,indiana,3231
2004,197,Army West Point,28,14,14,1747,62.4,armstrong,3118
2004,198,Elon,29,17,12,1809,62.4,elon,3189
2004,199,Saint Joseph's,33,22,11,2058,62.4,saint joseph's,3386
2004,200,UCF,30,17,13,1869,62.3,ucf,3416
2004,201,FIU,27,11,16,1681,62.3,fiu,3198
2004,202,Southern U.,30,17,13,1866,62.2,southern u.,3380
2004,203,Boise St.,29,9,20,1803,62.2,boise st.,3129
2004,204,Cornell,27,9,18,1675,62,cornell,3165
2004,205,North Texas,28,11,17,1736,62,north texas,3317
2004,206,Drexel,28,10,18,1735,62,drexel,3180
2004,207,Yale,27,8,19,1672,61.9,yale,3463
2004,208,Charleston So.,28,11,17,1733,61.9,charleston so.,3149
2004,209,SMU,28,13,15,1732,61.9,smu,3374
2004,209,High Point,28,14,14,1732,61.9,high point,3219
2004,211,Drake,31,16,15,1916,61.8,drake,3179
2004,212,Weber St.,28,17,11,1730,61.8,weber st.,3451
2004,213,New Mexico,31,23,8,1914,61.7,new mexico,3307
2004,214,Kansas,28,9,19,1727,61.7,kansas,3242
2004,215,Northeastern,30,15,15,1850,61.7,northeastern,3318
2004,216,Wagner,28,11,17,1725,61.6,wagner,3447
2004,217,CSUN,26,6,20,1601,61.6,lsu,3261
2004,218,Coastal Caro.,28,13,15,1723,61.5,coastal caro.,3157
2004,219,Northern Ariz.,28,12,16,1721,61.5,northern ariz.,3319
2004,220,American,30,16,14,1841,61.4,american,3110
2004,221,Columbia,26,12,14,1595,61.3,columbia,3162
2004,222,Chicago St.,28,8,20,1716,61.3,chicago st.,3152
2004,223,Marist,31,20,11,1899,61.3,marist,3265
2004,224,Temple,31,21,10,1897,61.2,temple,3396
2004,225,Loyola Marymount,30,24,6,1835,61.2,loyola marymount,3258
2004,226,Portland St.,28,6,22,1711,61.1,portland st.,3340
2004,227,Long Beach St.,30,14,16,1832,61.1,long beach st.,3253
2004,228,Alcorn,28,13,15,1709,61,alcorn,3108
2004,229,Wright St.,29,9,20,1770,61,wright st.,3460
2004,230,Radford,29,15,14,1769,61,radford,3347
2004,231,Fresno St.,29,13,16,1768,61,fresno st.,3201
2004,232,Michigan,31,14,17,1889,60.9,michigan,3276
2004,233,Southeastern La.,27,12,15,1645,60.9,southeastern la.,3368
2004,233,Southern Miss.,27,14,13,1645,60.9,southern miss.,3379
2004,235,Loyola Maryland,29,14,15,1765,60.9,loyola maryland,3259
2004,235,Oregon,29,14,15,1765,60.9,oregon,3332
2004,237,San Diego,29,7,22,1764,60.8,san diego,3360
2004,237,South Ala.,29,22,7,1764,60.8,south ala.,3375
2004,239,UTEP,29,16,13,1763,60.8,utep,3431
2004,240,UNC Asheville,28,19,9,1700,60.7,unc asheville,3421
2004,241,Villanova,30,23,7,1820,60.7,villanova,3437
2004,242,Denver,29,14,15,1755,60.5,denver,3176
2004,243,UNCW,28,15,13,1692,60.4,unc,3314
2004,244,Saint Peter's,30,15,15,1809,60.3,saint peter's,3389
2004,245,Texas A&M,28,9,19,1686,60.2,texas a&m,3401
2004,246,Cal St. Fullerton,29,9,20,1742,60.1,cal st. fullerton,3168
2004,247,Tulane,28,10,18,1681,60,tulane,3408
2004,248,Little Rock,27,10,17,1619,60,little rock,3114
2004,249,IUPUI,28,7,21,1677,59.9,iupui,3237
2004,250,Albany (NY),29,13,16,1736,59.9,albany (ny),3107
2004,251,Centenary (LA),27,4,23,1616,59.9,centenary (la),3147
2004,252,New Hampshire,29,11,18,1734,59.8,new hampshire,3306
2004,253,Col. of Charleston,29,7,22,1732,59.7,col. of charleston,3158
2004,254,South Carolina St.,28,9,19,1667,59.5,south carolina st.,3354
2004,255,Mercer,28,13,15,1665,59.5,mercer,3273
2004,256,Winthrop,27,5,22,1599,59.2,winthrop,3457
2004,256,Gardner-Webb,27,5,22,1599,59.2,gardner-webb,3205
2004,258,Binghamton,27,17,10,1598,59.2,binghamton,3127
2004,259,Nevada,29,3,26,1715,59.1,nevada,3305
2004,260,UNCG,28,9,19,1654,59.1,unc,3314
2004,261,San Francisco,28,10,18,1652,59,san francisco,3362
2004,262,Towson,28,9,19,1651,59,towson,3406
2004,263,Jackson St.,30,23,7,1768,58.9,jackson st.,3238
2004,264,Louisiana,28,13,15,1650,58.9,se louisiana,3368
2004,265,Hartford,30,18,12,1764,58.8,hartford,3216
2004,266,Southern Ill.,27,3,24,1587,58.8,southern ill.,3356
2004,267,Alabama A&M,28,12,16,1645,58.8,alabama a&m,3105
2004,268,Texas Southern,27,10,17,1586,58.7,texas southern,3411
2004,269,Fordham,28,11,17,1643,58.7,fordham,3200
2004,270,Buffalo,27,6,21,1584,58.7,buffalo,3138
2004,271,Delaware St.,30,21,9,1759,58.6,delaware st.,3175
2004,272,UTSA,29,15,14,1700,58.6,utsa,3427
2004,273,Oklahoma St.,28,8,20,1635,58.4,oklahoma st.,3329
2004,274,Ga. Southern,29,15,14,1692,58.3,ga. southern,3204
2004,275,Princeton,27,7,20,1574,58.3,princeton,3343
2004,276,Saint Mary's (CA),29,15,14,1688,58.2,saint mary's (ca),3388
2004,277,Norfolk St.,29,8,21,1685,58.1,norfolk st.,3313
2004,278,McNeese,28,11,17,1626,58.1,mcneese st,3270
2004,279,Campbell,27,9,18,1566,58,campbell,3144
2004,279,Utah St.,27,5,22,1566,58,utah st.,3429
2004,281,Seton Hall,30,15,15,1739,58,seton hall,3371
2004,282,Nicholls St.,27,2,25,1564,57.9,nicholls st.,3311
2004,283,Troy,28,11,17,1620,57.9,troy,3407
2004,283,Hawaii,28,8,20,1620,57.9,hawaii,3218
2004,285,Texas St.,27,8,19,1559,57.7,texas st.,3402
2004,286,Central Mich.,28,5,23,1615,57.7,central mich.,3141
2004,286,Washington St.,28,6,22,1615,57.7,washington st.,3450
2004,288,St. Francis Brooklyn,27,8,19,1554,57.6,st. francis brooklyn,3383
2004,289,Sam Houston St.,28,7,21,1609,57.5,sam houston st.,3358
2004,290,Wisconsin,27,10,17,1547,57.3,wisconsin,3458
2004,291,Dayton,28,3,25,1604,57.3,dayton,3173
2004,292,Detroit Mercy,29,17,12,1659,57.2,detroit mercy,3178
2004,293,New Mexico St.,29,13,16,1658,57.2,new mexico st.,3308
2004,294,Lafayette,28,1,27,1600,57.1,lafayette,3248
2004,295,Pittsburgh,26,6,20,1484,57.1,pittsburgh,3338
2004,296,Manhattan,29,11,18,1654,57,manhattan,3264
2004,297,Mississippi Val.,29,8,21,1652,57,mississippi val.,3290
2004,298,UC Irvine,26,6,20,1481,57,uc irvine,3414
2004,299,Birmingham-So.,30,13,17,1707,56.9,birmingham so,3128
2004,300,Ark.-Pine Bluff,27,4,23,1536,56.9,ark.-pine bluff,3115
2004,301,Jacksonville,27,3,24,1535,56.9,jacksonville,3239
2004,301,Samford,27,10,17,1535,56.9,samford,3359
2004,303,Akron,28,7,21,1570,56.1,akron,3103
2004,304,Prairie View,26,5,21,1449,55.7,prairie view,3341
2004,305,Wofford,28,0,28,1560,55.7,wofford,3459
2004,306,Air Force,28,3,25,1550,55.4,air force,3102
2004,307,Robert Morris,27,3,24,1493,55.3,robert morris,3352
2004,308,N.C. A&T,29,7,22,1603,55.3,n.c. a&t,3299
2004,309,UTRGV,28,13,15,1546,55.2,utrgv,3410
2004,310,Providence,27,4,23,1483,54.9,providence,3344
2004,311,Lamar University,26,4,22,1411,54.3,american university,3110
2004,312,LIU Brooklyn,28,11,17,1518,54.2,liu brooklyn,3254
2004,313,Youngstown St.,28,3,25,1515,54.1,youngstown st.,3464
2004,314,San Diego St.,28,8,20,1503,53.7,san diego st.,3361
2004,315,Central Conn. St.,27,4,23,1440,53.3,central conn. st.,3148
2004,316,Syracuse,27,6,21,1437,53.2,syracuse,3393
2004,317,Massachusetts,28,6,22,1480,52.9,massachusetts,3269
2004,318,Wyoming,29,11,18,1525,52.6,wyoming,3461
2004,319,Savannah St.,26,6,20,1361,52.3,savannah st.,3366
2004,320,Northwestern,28,8,20,1460,52.1,northwestern,3321
2004,321,Morgan St.,28,3,25,1402,50.1,morgan st.,3288
2004,322,Sacramento St.,27,1,26,1349,50,sacramento st.,3170
2004,323,Tennessee St.,26,1,25,1293,49.7,tennessee st.,3398
2004,324,UMBC,28,4,24,1330,47.5,umbc,3420
2005,1,DePaul,31,26,5,2563,82.7,depaul,3177
2005,2,North Carolina,34,30,4,2701,79.4,north carolina,3314
2005,3,Western Ky.,30,20,10,2354,78.5,western ky.,3443
2005,4,Stanford,35,32,3,2724,77.8,stanford,3390
2005,5,Vanderbilt,32,24,8,2480,77.5,vanderbilt,3435
2005,6,Duke,36,31,5,2737,76,duke,3181
2005,7,Indiana St.,32,23,9,2432,76,indiana st.,3232
2005,8,Iowa St.,30,23,7,2273,75.8,iowa st.,3235
2005,9,Baylor,36,33,3,2673,74.3,baylor,3124
2005,10,Missouri St.,33,25,8,2449,74.2,missouri st.,3283
2005,11,Virginia Tech,29,17,12,2143,73.9,virginia tech,3439
2005,12,Southeast Mo. St.,30,22,8,2214,73.8,southeast mo. st.,3369
2005,13,Louisiana Tech,30,20,10,2194,73.1,louisiana tech,3256
2005,14,Maryland,32,22,10,2328,72.8,maryland,3268
2005,15,Ohio St.,35,30,5,2542,72.6,ohio st.,3326
2005,16,Georgia,34,24,10,2465,72.5,georgia,3208
2005,17,Tennessee,35,30,5,2526,72.2,tennessee,3397
2005,18,UCLA,28,16,12,2017,72,ucla,3417
2005,19,Green Bay,31,27,4,2232,72,green bay,3453
2005,20,LSU,36,33,3,2588,71.9,lsu,3261
2005,21,Charlotte,31,22,9,2226,71.8,charlotte,3150
2005,22,Creighton,29,19,10,2080,71.7,creighton,3166
2005,23,Texas Tech,32,24,8,2293,71.7,texas tech,3403
2005,24,Santa Clara,31,17,14,2220,71.6,santa clara,3365
2005,25,Kansas St.,32,24,8,2284,71.4,kansas st.,3243
2005,26,UC Santa Barbara,30,21,9,2137,71.2,uc santa barbara,3364
2005,27,Old Dominion,31,22,9,2207,71.2,old dominion,3330
2005,28,Harvard,28,20,8,1991,71.1,harvard,3217
2005,29,Bowling Green,31,23,8,2204,71.1,bowling green,3132
2005,30,Michigan St.,37,33,4,2628,71,michigan st.,3277
2005,31,Liberty,33,26,7,2334,70.7,liberty,3251
2005,32,Ole Miss,30,19,11,2119,70.6,ole miss,3279
2005,33,TCU,33,23,10,2330,70.6,tcu,3395
2005,33,UConn,33,25,8,2330,70.6,uconn,3163
2005,35,Arizona,32,20,12,2258,70.6,arizona,3112
2005,36,Wake Forest,32,17,15,2254,70.4,wake forest,3448
2005,37,Bradley,28,15,13,1970,70.4,bradley,3133
2005,38,Eastern Ky.,31,23,8,2179,70.3,eastern ky.,3184
2005,39,Marshall,29,19,10,2037,70.2,marshall,3267
2005,40,Northwestern St.,29,17,12,2032,70.1,northwestern st.,3322
2005,41,Texas,31,22,9,2170,70,texas,3400
2005,42,Tennessee Tech,29,21,8,2028,69.9,tennessee tech,3399
2005,43,Iowa,33,23,10,2304,69.8,iowa,3234
2005,44,Oakland,29,21,8,2018,69.6,oakland,3324
2005,45,Eastern Mich.,31,23,8,2156,69.5,eastern mich.,3185
2005,46,Western Caro.,32,18,14,2221,69.4,western caro.,3441
2005,47,Gonzaga,32,28,4,2220,69.4,gonzaga,3211
2005,48,Arkansas St.,32,21,11,2218,69.3,arkansas st.,3117
2005,49,Penn St.,30,19,11,2076,69.2,penn st.,3336
2005,50,Florida St.,32,24,8,2210,69.1,florida st.,3199
2005,51,Kentucky,34,18,16,2348,69.1,kentucky,3246
2005,52,Long Beach St.,28,19,9,1933,69,long beach st.,3253
2005,53,Oklahoma,30,17,13,2071,69,oklahoma,3328
2005,54,Nebraska,32,18,14,2203,68.8,nebraska,3304
2005,55,Tulsa,30,19,11,2065,68.8,tulsa,3409
2005,56,Colgate,30,12,18,2061,68.7,colgate,3159
2005,57,Ohio,29,13,16,1992,68.7,ohio,3325
2005,58,Southern California,31,20,11,2123,68.5,southern california,3425
2005,59,Wisconsin,28,12,16,1912,68.3,wisconsin,3458
2005,60,Xavier,32,22,10,2185,68.3,xavier,3462
2005,61,Weber St.,29,21,8,1980,68.3,weber st.,3451
2005,62,Illinois St.,31,13,18,2115,68.2,illinois st.,3229
2005,63,Idaho St.,29,13,16,1976,68.1,idaho st.,3226
2005,64,Saint Francis (PA),31,21,10,2111,68.1,saint francis (pa),3384
2005,65,Ball St.,29,16,13,1973,68,ball st.,3123
2005,66,Howard,29,17,12,1971,68,howard,3224
2005,67,Fresno St.,31,20,11,2105,67.9,fresno st.,3201
2005,68,Minnesota,34,26,8,2308,67.9,minnesota,3278
2005,69,NC State,29,21,8,1968,67.9,nc state,3301
2005,70,West Virginia,34,21,13,2305,67.8,west virginia,3452
2005,71,Virginia,32,21,11,2166,67.7,virginia,3438
2005,72,Stony Brook,28,8,20,1890,67.5,stony brook,3392
2005,73,Rice,33,24,9,2227,67.5,rice,3349
2005,74,Kent St.,30,21,9,2021,67.4,kent st.,3245
2005,75,Chattanooga,30,25,5,2020,67.3,chattanooga,3151
2005,76,Mississippi St.,29,17,12,1952,67.3,mississippi st.,3280
2005,77,Washington,30,14,16,2017,67.2,washington,3449
2005,77,A&M-Corpus Christi,30,23,7,2017,67.2,a&m-corpus chris,3394
2005,79,Evansville,28,17,11,1882,67.2,evansville,3191
2005,80,Murray St.,28,9,19,1881,67.2,murray st.,3293
2005,81,Boston College,30,20,10,2013,67.1,boston college,3130
2005,82,Davidson,29,18,11,1943,67,davidson,3172
2005,83,UNLV,31,16,15,2075,66.9,unlv,3424
2005,84,Alabama,29,14,15,1940,66.9,alabama,3104
2005,85,Belmont,28,17,11,1868,66.7,belmont,3125
2005,86,Canisius,31,21,10,2068,66.7,canisius,3145
2005,87,Florida,29,14,15,1933,66.7,florida,3196
2005,88,Coppin St.,31,23,8,2065,66.6,coppin st.,3164
2005,89,La.-Monroe,30,22,8,1998,66.6,la.-monroe,3419
2005,90,Temple,32,28,4,2131,66.6,temple,3396
2005,91,ETSU,30,13,17,1995,66.5,etsu,3190
2005,92,Marquette,30,18,12,1993,66.4,marquette,3266
2005,93,Jacksonville St.,29,15,14,1926,66.4,jacksonville st.,3240
2005,94,Louisiana,31,22,9,2058,66.4,se louisiana,3368
2005,95,Notre Dame,33,27,6,2188,66.3,notre dame,3323
2005,96,Furman,28,18,10,1854,66.2,furman,3202
2005,97,Houston,30,21,9,1985,66.2,houston,3222
2005,98,Arkansas,31,17,14,2051,66.2,arkansas,3116
2005,99,Ill.-Chicago,29,14,15,1918,66.1,ill.-chicago,3227
2005,100,Idaho,30,19,11,1979,66,idaho,3225
2005,101,Vermont,29,14,15,1912,65.9,vermont,3436
2005,102,Utah,34,26,8,2241,65.9,utah,3428
2005,103,Dartmouth,28,17,11,1841,65.8,dartmouth,3171
2005,104,California,29,11,18,1905,65.7,california,3143
2005,105,CSUN,29,18,11,1903,65.6,lsu,3261
2005,106,South Fla.,32,21,11,2099,65.6,south fla.,3378
2005,107,Hofstra,29,13,16,1900,65.5,hofstra,3220
2005,108,Oregon,31,21,10,2030,65.5,oregon,3332
2005,109,Fairfield,29,12,17,1898,65.4,fairfield,3193
2005,110,Illinois,30,17,13,1963,65.4,illinois,3228
2005,111,Holy Cross,31,20,11,2028,65.4,holy cross,3221
2005,111,Richmond,31,23,8,2028,65.4,richmond,3350
2005,113,New Mexico,31,26,5,2027,65.4,new mexico,3307
2005,114,Louisville,31,22,9,2024,65.3,louisville,3257
2005,115,Drake,29,14,15,1885,65,drake,3179
2005,116,St. John's (NY),31,20,11,2012,64.9,st. john's (ny),3385
2005,117,Lehigh,29,19,10,1881,64.9,lehigh,3250
2005,118,Miami (OH),29,15,14,1877,64.7,miami (oh),3275
2005,119,Fla. Atlantic,28,12,16,1812,64.7,fla. atlantic,3194
2005,120,Colorado St.,28,15,13,1811,64.7,colorado st.,3161
2005,121,Ga. Southern,30,16,14,1940,64.7,ga. southern,3204
2005,122,Texas St.,28,14,14,1810,64.6,texas st.,3402
2005,123,Alcorn,30,21,9,1938,64.6,alcorn,3108
2005,124,Middle Tenn.,33,24,9,2130,64.5,middle tenn.,3292
2005,125,Delaware,31,25,6,2000,64.5,delaware,3174
2005,126,SMU,30,19,11,1934,64.5,smu,3374
2005,127,Niagara,29,17,12,1869,64.4,niagara,3310
2005,128,Eastern Ill.,27,10,17,1739,64.4,eastern ill.,3183
2005,129,Stetson,31,17,14,1996,64.4,stetson,3391
2005,130,Boston U.,31,15,16,1995,64.4,boston u.,3131
2005,131,Wright St.,30,19,11,1928,64.3,wright st.,3460
2005,132,Texas A&M,31,16,15,1992,64.3,texas a&m,3401
2005,133,James Madison,29,18,11,1863,64.2,james madison,3241
2005,134,Sacred Heart,29,18,11,1862,64.2,sacred heart,3357
2005,135,Western Mich.,28,10,18,1797,64.2,western mich.,3444
2005,136,BYU,30,19,11,1924,64.1,byu,3140
2005,137,Miami (FL),29,13,16,1856,64,miami (fl),3274
2005,138,George Washington,32,23,9,2044,63.9,george washington,3203
2005,139,Auburn,29,16,13,1849,63.8,auburn,3120
2005,140,Milwaukee,28,14,14,1783,63.7,milwaukee,3454
2005,140,Eastern Wash.,28,16,12,1783,63.7,eastern wash.,3186
2005,142,Arizona St.,34,24,10,2165,63.7,arizona st.,3113
2005,143,Utah St.,28,14,14,1782,63.6,utah st.,3429
2005,144,Northern Ariz.,29,19,10,1844,63.6,northern ariz.,3319
2005,145,Montana,30,22,8,1904,63.5,montana,3285
2005,146,Oral Roberts,31,22,9,1966,63.4,oral roberts,3331
2005,147,Brown,27,18,9,1712,63.4,brown,3135
2005,148,Central Mich.,28,10,18,1775,63.4,central mich.,3141
2005,149,Appalachian St.,28,11,17,1772,63.3,appalachian st.,3111
2005,150,La Salle,28,12,16,1771,63.3,la salle,3247
2005,151,Iona,28,6,22,1770,63.2,iona,3233
2005,152,Rutgers,35,28,7,2212,63.2,rutgers,3353
2005,153,Saint Peter's,28,11,17,1769,63.2,saint peter's,3389
2005,154,Austin Peay,27,8,19,1703,63.1,austin peay,3122
2005,155,Maine,30,20,10,1891,63,maine,3263
2005,156,Lipscomb,28,13,15,1763,63,lipscomb,3252
2005,156,Colorado,28,9,19,1763,63,colorado,3160
2005,158,N.C. A&T,28,10,18,1758,62.8,n.c. a&t,3299
2005,159,Quinnipiac,29,16,13,1820,62.8,quinnipiac,3346
2005,160,Youngstown St.,28,12,16,1757,62.8,youngstown st.,3464
2005,160,Georgetown,28,12,16,1757,62.8,georgetown,3207
2005,162,Robert Morris,30,20,10,1882,62.7,robert morris,3352
2005,163,Cal Poly,27,11,16,1693,62.7,cal poly,3142
2005,164,FIU,29,18,11,1817,62.7,fiu,3198
2005,165,Hampton,27,14,13,1691,62.6,hampton,3214
2005,166,Northeastern,29,14,15,1816,62.6,northeastern,3318
2005,166,UC Irvine,29,8,21,1816,62.6,uc irvine,3414
2005,168,Troy,29,14,15,1815,62.6,troy,3407
2005,169,High Point,29,17,12,1814,62.6,high point,3219
2005,170,Georgia St.,30,16,14,1875,62.5,georgia st.,3209
2005,171,Pittsburgh,28,13,15,1749,62.5,pittsburgh,3338
2005,172,San Francisco,28,12,16,1748,62.4,san francisco,3362
2005,173,Army West Point,28,15,13,1747,62.4,armstrong,3118
2005,174,Lamar University,27,9,18,1683,62.3,american university,3110
2005,175,Purdue,30,17,13,1865,62.2,purdue,3345
2005,176,UNI,31,20,11,1926,62.1,uni,3320
2005,177,San Diego,28,9,19,1738,62.1,san diego,3360
2005,178,Duquesne,28,10,18,1737,62,duquesne,3182
2005,178,UNCG,28,14,14,1737,62,unc,3314
2005,180,Clemson,28,8,20,1736,62,clemson,3155
2005,181,Florida A&M,30,14,16,1856,61.9,florida a&m,3197
2005,181,Towson,30,16,14,1856,61.9,towson,3406
2005,183,SFA,28,12,16,1731,61.8,utsa,3427
2005,184,Wyoming,28,16,12,1722,61.5,wyoming,3461
2005,185,Toledo,29,14,15,1782,61.4,toledo,3405
2005,186,Morehead St.,27,5,22,1658,61.4,morehead st.,3287
2005,187,Western Ill.,28,19,9,1719,61.4,western ill.,3442
2005,188,UC Riverside,29,16,13,1780,61.4,uc riverside,3415
2005,189,Memphis,29,13,16,1777,61.3,memphis,3272
2005,190,San Jose St.,30,18,12,1838,61.3,san jose st.,3363
2005,191,Monmouth,28,17,11,1714,61.2,monmouth,3284
2005,192,Southeastern La.,27,10,17,1651,61.1,southeastern la.,3368
2005,193,Albany (NY),28,14,14,1712,61.1,albany (ny),3107
2005,194,Montana St.,27,9,18,1648,61,montana st.,3286
2005,195,UTEP,29,12,17,1769,61,utep,3431
2005,196,Saint Mary's (CA),28,15,13,1706,60.9,saint mary's (ca),3388
2005,197,Norfolk St.,30,12,18,1826,60.9,norfolk st.,3313
2005,198,Valparaiso,28,18,10,1703,60.8,valparaiso,3434
2005,199,UCF,29,19,10,1761,60.7,ucf,3416
2005,200,Loyola Chicago,28,7,21,1700,60.7,loyola chicago,3260
2005,201,Oregon St.,29,6,23,1757,60.6,oregon st.,3333
2005,202,Mercer,28,12,16,1695,60.5,mercer,3273
2005,203,East Carolina,28,10,18,1693,60.5,east carolina,3187
2005,203,UTSA,28,16,12,1693,60.5,utsa,3427
2005,205,Hawaii,26,11,15,1572,60.5,hawaii,3218
2005,206,Tulane,27,11,16,1632,60.4,tulane,3408
2005,207,UNC Asheville,30,18,12,1809,60.3,unc asheville,3421
2005,208,Loyola Marymount,29,16,13,1748,60.3,loyola marymount,3258
2005,209,UT Martin,28,9,19,1687,60.3,ut martin,3404
2005,210,Mt. St. Mary's,28,9,19,1683,60.1,mt. st. mary's,3291
2005,211,Cleveland St.,29,4,25,1740,60,cleveland st.,3156
2005,212,Radford,28,12,16,1677,59.9,radford,3347
2005,213,Missouri,29,11,18,1734,59.8,missouri,3281
2005,214,Drexel,29,19,10,1733,59.8,drexel,3180
2005,215,Wofford,28,4,24,1672,59.7,wofford,3459
2005,215,Fort Wayne,28,5,23,1672,59.7,iupu-fort wayne,3236
2005,217,Southern Utah,28,11,17,1670,59.6,southern utah,3381
2005,218,Boise St.,29,10,19,1729,59.6,boise st.,3129
2005,219,UT Arlington,31,21,10,1848,59.6,ut arlington,3426
2005,220,Butler,28,14,14,1669,59.6,butler,3139
2005,221,Nevada,30,8,22,1788,59.6,nevada,3305
2005,222,Binghamton,28,10,18,1668,59.6,binghamton,3127
2005,223,VCU,29,11,18,1726,59.5,vcu,3433
2005,224,Navy,29,11,18,1725,59.5,navy,3298
2005,225,Morgan St.,27,4,23,1605,59.4,morgan st.,3288
2005,226,Bucknell,28,10,18,1663,59.4,bucknell,3137
2005,227,Cal St. Fullerton,28,8,20,1661,59.3,cal st. fullerton,3168
2005,228,Siena,29,13,16,1720,59.3,siena,3373
2005,229,Marist,29,22,7,1717,59.2,marist,3265
2005,230,Jacksonville,27,6,21,1597,59.1,jacksonville,3239
2005,231,Grambling,29,14,15,1715,59.1,grambling,3212
2005,232,Penn,27,15,12,1596,59.1,penn,3335
2005,233,New Hampshire,29,15,14,1713,59.1,new hampshire,3306
2005,234,Princeton,27,13,14,1594,59,princeton,3343
2005,235,Rhode Island,28,8,20,1651,59,rhode island,3348
2005,236,Pepperdine,29,12,17,1709,58.9,pepperdine,3337
2005,237,Tennessee St.,28,11,17,1646,58.8,tennessee st.,3398
2005,238,Gardner-Webb,27,9,18,1586,58.7,gardner-webb,3205
2005,239,Villanova,31,19,12,1816,58.6,villanova,3437
2005,240,Portland,28,6,22,1640,58.6,portland,3339
2005,241,Wichita St.,27,5,22,1579,58.5,wichita st.,3455
2005,242,UTRGV,28,14,14,1637,58.5,utrgv,3410
2005,242,Nicholls St.,28,8,20,1637,58.5,nicholls st.,3311
2005,244,Loyola Maryland,28,10,18,1636,58.4,loyola maryland,3259
2005,245,George Mason,28,12,16,1634,58.4,george mason,3206
2005,246,Air Force,28,7,21,1633,58.3,air force,3102
2005,247,Southern U.,30,16,14,1746,58.2,southern u.,3380
2005,248,Georgia Tech,27,13,14,1571,58.2,georgia tech,3210
2005,249,UNCW,28,8,20,1628,58.1,unc,3314
2005,250,Dayton,28,12,16,1626,58.1,dayton,3173
2005,251,South Carolina,29,8,21,1684,58.1,south carolina,3376
2005,252,Kansas,28,12,16,1625,58,kansas,3242
2005,253,Col. of Charleston,29,15,14,1683,58,col. of charleston,3158
2005,254,Birmingham-So.,28,13,15,1624,58,birmingham so,3128
2005,255,Oklahoma St.,27,7,20,1563,57.9,oklahoma st.,3329
2005,256,Syracuse,29,13,16,1676,57.8,syracuse,3393
2005,257,UAB,28,7,21,1617,57.8,uab,3412
2005,257,North Texas,28,14,14,1617,57.8,north texas,3317
2005,259,Sam Houston St.,27,7,20,1557,57.7,sam houston st.,3358
2005,259,Fairleigh Dickinson,27,2,25,1557,57.7,fairleigh dickinson,3192
2005,261,McNeese,29,10,19,1672,57.7,mcneese st,3270
2005,262,St. Bonaventure,28,9,19,1612,57.6,st. bonaventure,3382
2005,263,Washington St.,28,6,22,1610,57.5,washington st.,3450
2005,264,San Diego St.,28,8,20,1609,57.5,san diego st.,3361
2005,265,Alabama A&M,28,16,12,1607,57.4,alabama a&m,3105
2005,266,Bethune-Cookman,25,5,20,1433,57.3,bethune-cookman,3126
2005,267,Jackson St.,28,11,17,1604,57.3,jackson st.,3238
2005,268,Southern Miss.,28,9,19,1603,57.3,southern miss.,3379
2005,268,UMES,28,12,16,1603,57.3,umes,3271
2005,270,Hartford,31,22,9,1773,57.2,hartford,3216
2005,271,Cincinnati,28,9,19,1600,57.1,cincinnati,3153
2005,272,Michigan,28,5,23,1598,57.1,michigan,3276
2005,273,LIU Brooklyn,27,9,18,1540,57,liu brooklyn,3254
2005,274,Northwestern,30,5,25,1711,57,northwestern,3321
2005,275,Manhattan,29,11,18,1653,57,manhattan,3264
2005,275,Northern Ill.,28,7,21,1596,57,northern ill.,3296
2005,277,Rider,29,9,20,1652,57,rider,3351
2005,278,South Carolina St.,29,10,19,1645,56.7,south carolina st.,3354
2005,279,American,28,12,16,1588,56.7,american,3110
2005,280,Saint Louis,27,4,23,1530,56.7,saint louis,3387
2005,281,Detroit Mercy,29,9,20,1643,56.7,detroit mercy,3178
2005,282,Chicago St.,28,13,15,1586,56.6,chicago st.,3152
2005,283,Columbia,27,12,15,1528,56.6,columbia,3162
2005,284,Campbell,27,9,18,1522,56.4,campbell,3144
2005,285,Central Conn. St.,28,9,19,1577,56.3,central conn. st.,3148
2005,286,Charleston So.,28,13,15,1576,56.3,charleston so.,3149
2005,287,St. Francis Brooklyn,28,10,18,1571,56.1,st. francis brooklyn,3383
2005,288,Sacramento St.,28,8,20,1570,56.1,sacramento st.,3170
2005,289,South Ala.,28,13,15,1568,56,south ala.,3375
2005,289,Samford,28,13,15,1568,56,samford,3359
2005,291,Alabama St.,29,15,14,1621,55.9,alabama st.,3106
2005,292,UMKC,30,10,20,1671,55.7,umkc,3282
2005,293,Portland St.,26,3,23,1448,55.7,portland st.,3340
2005,294,William & Mary,28,4,24,1557,55.6,william & mary,3456
2005,295,Massachusetts,29,14,15,1601,55.2,massachusetts,3269
2005,296,Akron,28,3,25,1540,55,akron,3103
2005,297,Coastal Caro.,27,9,18,1483,54.9,coastal caro.,3157
2005,298,Lafayette,28,5,23,1533,54.8,lafayette,3248
2005,299,Texas Southern,28,5,23,1531,54.7,texas southern,3411
2005,300,Yale,27,6,21,1475,54.6,yale,3463
2005,301,Little Rock,29,10,19,1584,54.6,little rock,3114
2005,302,UMBC,28,8,20,1528,54.6,umbc,3420
2005,303,Southern Ill.,27,3,24,1467,54.3,southern ill.,3356
2005,304,IUPUI,28,7,21,1513,54,iupui,3237
2005,305,Mississippi Val.,28,11,17,1510,53.9,mississippi val.,3290
2005,306,Fordham,31,10,21,1663,53.6,fordham,3200
2005,307,Cornell,27,3,24,1447,53.6,cornell,3165
2005,308,Seton Hall,28,14,14,1486,53.1,seton hall,3371
2005,309,Buffalo,28,4,24,1470,52.5,buffalo,3138
2005,309,Savannah St.,28,6,22,1470,52.5,savannah st.,3366
2005,311,Ark.-Pine Bluff,27,6,21,1417,52.5,ark.-pine bluff,3115
2005,312,Denver,28,6,22,1469,52.5,denver,3176
2005,313,Elon,28,4,24,1467,52.4,elon,3189
2005,314,Centenary (LA),26,1,25,1360,52.3,centenary (la),3147
2005,315,Pacific,27,5,22,1412,52.3,pacific,3334
2005,316,Indiana,28,10,18,1448,51.7,indiana,3231
2005,317,New Mexico St.,28,9,19,1439,51.4,new mexico st.,3308
2005,318,Prairie View,27,6,21,1387,51.4,prairie view,3341
2005,319,Saint Joseph's,30,7,23,1540,51.3,saint joseph's,3386
2005,320,Wagner,27,2,25,1378,51,wagner,3447
2005,321,Delaware St.,28,16,12,1382,49.4,delaware st.,3175
2005,322,New Orleans,28,2,26,1320,47.1,new orleans,3309
2005,323,Winthrop,28,2,26,1309,46.8,winthrop,3457
2006,1,Duke,35,31,4,3009,86,duke,3181
2006,2,Maryland,38,34,4,3166,83.3,maryland,3268
2006,3,North Carolina,35,33,2,2877,82.2,north carolina,3314
2006,4,Georgia,32,23,9,2554,79.8,georgia,3208
2006,5,Stanford,34,26,8,2671,78.6,stanford,3390
2006,6,Tennessee,36,31,5,2819,78.3,tennessee,3397
2006,7,UCLA,32,21,11,2475,77.3,ucla,3417
2006,8,Idaho St.,30,17,13,2313,77.1,idaho st.,3226
2006,9,Oklahoma,36,31,5,2748,76.3,oklahoma,3328
2006,10,Indiana St.,33,27,6,2512,76.1,indiana st.,3232
2006,11,Miami (FL),30,17,13,2274,75.8,miami (fl),3274
2006,12,DePaul,34,27,7,2558,75.2,depaul,3177
2006,13,Chattanooga,31,27,4,2328,75.1,chattanooga,3151
2006,14,Baylor,33,26,7,2469,74.8,baylor,3124
2006,15,Old Dominion,31,22,9,2303,74.3,old dominion,3330
2006,16,LSU,35,31,4,2595,74.1,lsu,3261
2006,17,Western Ky.,34,27,7,2510,73.8,western ky.,3443
2006,18,Howard,29,14,15,2127,73.3,howard,3224
2006,19,Charlotte,30,21,9,2190,73,charlotte,3150
2006,20,Louisiana Tech,31,26,5,2261,72.9,louisiana tech,3256
2006,21,Santa Clara,31,19,12,2258,72.8,santa clara,3365
2006,22,UConn,37,32,5,2692,72.8,uconn,3163
2006,23,Cal Poly,27,13,14,1953,72.3,cal poly,3142
2006,24,Iowa,29,17,12,2097,72.3,iowa,3234
2006,25,Middle Tenn.,31,20,11,2233,72,middle tenn.,3292
2006,26,Ole Miss,31,17,14,2222,71.7,ole miss,3279
2006,27,Sacred Heart,31,26,5,2221,71.6,sacred heart,3357
2006,28,Green Bay,30,23,7,2148,71.6,green bay,3453
2006,29,Ohio St.,32,29,3,2289,71.5,ohio st.,3326
2006,30,Florida St.,30,20,10,2139,71.3,florida st.,3199
2006,31,SFA,31,23,8,2210,71.3,utsa,3427
2006,32,St. John's (NY),30,22,8,2132,71.1,st. john's (ny),3385
2006,33,Murray St.,28,11,17,1989,71,murray st.,3293
2006,34,Southeast Mo. St.,31,22,9,2201,71,southeast mo. st.,3369
2006,35,Arizona St.,32,25,7,2270,70.9,arizona st.,3113
2006,36,Wichita St.,28,15,13,1984,70.9,wichita st.,3455
2006,37,Florida,30,21,9,2119,70.6,florida,3196
2006,38,Xavier,30,21,9,2116,70.5,xavier,3462
2006,39,Montana,28,21,7,1972,70.4,montana,3285
2006,40,Washington,30,19,11,2111,70.4,washington,3449
2006,41,Portland St.,28,12,16,1967,70.3,portland st.,3340
2006,42,Kansas St.,34,24,10,2386,70.2,kansas st.,3243
2006,43,Tulsa,32,26,6,2245,70.2,tulsa,3409
2006,44,Fresno St.,32,24,8,2244,70.1,fresno st.,3201
2006,45,Western Mich.,28,14,14,1961,70,western mich.,3444
2006,46,Vanderbilt,32,21,11,2239,70,vanderbilt,3435
2006,47,Jacksonville St.,28,11,17,1953,69.8,jacksonville st.,3240
2006,48,Texas A&M,32,23,9,2227,69.6,texas a&m,3401
2006,49,Missouri,31,21,10,2153,69.5,missouri,3281
2006,50,UAB,28,14,14,1943,69.4,uab,3412
2006,51,Virginia Tech,31,21,10,2149,69.3,virginia tech,3439
2006,52,Canisius,29,18,11,2008,69.2,canisius,3145
2006,53,Tennessee Tech,32,23,9,2215,69.2,tennessee tech,3399
2006,54,Utah,34,27,7,2353,69.2,utah,3428
2006,55,South Fla.,31,19,12,2145,69.2,south fla.,3378
2006,56,Dartmouth,30,23,7,2075,69.2,dartmouth,3171
2006,57,Butler,29,15,14,2004,69.1,butler,3139
2006,58,Bowling Green,31,28,3,2142,69.1,bowling green,3132
2006,59,ETSU,28,18,10,1934,69.1,etsu,3190
2006,60,South Carolina,29,17,12,2002,69,south carolina,3376
2006,61,Kentucky,31,22,9,2135,68.9,kentucky,3246
2006,62,NC State,31,19,12,2132,68.8,nc state,3301
2006,63,Hofstra,31,19,12,2131,68.7,hofstra,3220
2006,64,Western Caro.,29,9,20,1990,68.6,western caro.,3441
2006,64,Louisville,29,19,10,1990,68.6,louisville,3257
2006,66,Southern California,31,19,12,2125,68.5,southern california,3425
2006,67,Wake Forest,28,12,16,1918,68.5,wake forest,3448
2006,68,Michigan St.,34,24,10,2328,68.5,michigan st.,3277
2006,69,Texas St.,28,17,11,1916,68.4,texas st.,3402
2006,70,Fla. Atlantic,31,20,11,2120,68.4,fla. atlantic,3194
2006,71,Ill.-Chicago,30,16,14,2051,68.4,ill.-chicago,3227
2006,72,James Madison,31,24,7,2116,68.3,james madison,3241
2006,73,Boston College,33,21,12,2250,68.2,boston college,3130
2006,74,Tulane,27,15,12,1838,68.1,tulane,3408
2006,75,Oral Roberts,28,16,12,1905,68,oral roberts,3331
2006,76,Belmont,30,22,8,2034,67.8,belmont,3125
2006,77,Cal St. Fullerton,28,11,17,1895,67.7,cal st. fullerton,3168
2006,78,Nebraska,32,19,13,2165,67.7,nebraska,3304
2006,79,TCU,31,19,12,2097,67.6,tcu,3395
2006,80,Arkansas St.,30,15,15,2029,67.6,arkansas st.,3117
2006,81,Stony Brook,30,20,10,2028,67.6,stony brook,3392
2006,82,Iona,29,17,12,1959,67.6,iona,3233
2006,83,Army West Point,31,20,11,2094,67.5,armstrong,3118
2006,84,Minnesota,29,19,10,1958,67.5,minnesota,3278
2006,85,Long Beach St.,28,18,10,1890,67.5,long beach st.,3253
2006,86,Cincinnati,29,17,12,1957,67.5,cincinnati,3153
2006,87,UNCG,30,18,12,2023,67.4,unc,3314
2006,88,Princeton,28,21,7,1886,67.4,princeton,3343
2006,89,Purdue,33,26,7,2221,67.3,purdue,3345
2006,90,Milwaukee,31,22,9,2083,67.2,milwaukee,3454
2006,91,Rice,32,18,14,2150,67.2,rice,3349
2006,92,Pittsburgh,33,22,11,2217,67.2,pittsburgh,3338
2006,93,Illinois St.,28,12,16,1881,67.2,illinois st.,3229
2006,94,Iowa St.,31,18,13,2081,67.1,iowa st.,3235
2006,95,Hawaii,28,18,10,1878,67.1,hawaii,3218
2006,95,Appalachian St.,28,15,13,1878,67.1,appalachian st.,3111
2006,97,Boston U.,30,18,12,2007,66.9,boston u.,3131
2006,98,Binghamton,29,17,12,1940,66.9,binghamton,3127
2006,99,North Texas,28,19,9,1872,66.9,north texas,3317
2006,100,Northern Ariz.,33,22,11,2206,66.8,northern ariz.,3319
2006,101,Virginia,32,20,12,2139,66.8,virginia,3438
2006,102,Eastern Ill.,29,10,19,1938,66.8,eastern ill.,3183
2006,103,New Mexico,32,22,10,2135,66.7,new mexico,3307
2006,104,Loyola Maryland,30,20,10,1997,66.6,loyola maryland,3259
2006,105,Grambling,26,11,15,1730,66.5,grambling,3212
2006,106,Arizona,30,8,22,1996,66.5,arizona,3112
2006,106,Colorado,30,9,21,1996,66.5,colorado,3160
2006,108,Northwestern St.,27,11,16,1794,66.4,northwestern st.,3322
2006,109,Penn St.,29,13,16,1926,66.4,penn st.,3336
2006,110,High Point,30,20,10,1992,66.4,high point,3219
2006,111,Morehead St.,29,16,13,1925,66.4,morehead st.,3287
2006,112,Kansas,30,17,13,1991,66.4,kansas,3242
2006,113,Eastern Ky.,27,7,20,1791,66.3,eastern ky.,3184
2006,114,West Virginia,31,15,16,2056,66.3,west virginia,3452
2006,115,Wisconsin,29,11,18,1922,66.3,wisconsin,3458
2006,116,Clemson,29,8,21,1921,66.2,clemson,3155
2006,117,Kent St.,30,21,9,1986,66.2,kent st.,3245
2006,118,UMES,29,16,13,1919,66.2,umes,3271
2006,119,Davidson,29,17,12,1918,66.1,davidson,3172
2006,120,Boise St.,30,15,15,1984,66.1,boise st.,3129
2006,121,Navy,28,14,14,1849,66,navy,3298
2006,122,Arkansas,28,13,15,1846,65.9,arkansas,3116
2006,123,Mt. St. Mary's,28,12,16,1844,65.9,mt. st. mary's,3291
2006,124,Evansville,29,16,13,1909,65.8,evansville,3191
2006,125,Marquette,33,22,11,2169,65.7,marquette,3266
2006,126,Ball St.,29,17,12,1902,65.6,ball st.,3123
2006,127,UC Irvine,28,9,19,1836,65.6,uc irvine,3414
2006,128,Southern Miss.,29,14,15,1900,65.5,southern miss.,3379
2006,129,Hartford,31,27,4,2031,65.5,hartford,3216
2006,130,Texas Tech,29,15,14,1893,65.3,texas tech,3403
2006,131,BYU,32,26,6,2088,65.3,byu,3140
2006,132,Detroit Mercy,28,11,17,1826,65.2,detroit mercy,3178
2006,133,SMU,30,16,14,1956,65.2,smu,3374
2006,134,Quinnipiac,30,22,8,1955,65.2,quinnipiac,3346
2006,135,Oakland,31,15,16,2020,65.2,oakland,3324
2006,136,Colorado St.,29,9,20,1888,65.1,colorado st.,3161
2006,137,Austin Peay,28,15,13,1821,65,austin peay,3122
2006,138,Eastern Mich.,30,22,8,1951,65,eastern mich.,3185
2006,139,Harvard,27,12,15,1751,64.9,harvard,3217
2006,140,CSUN,30,10,20,1945,64.8,lsu,3261
2006,141,California,30,18,12,1944,64.8,california,3143
2006,142,FIU,32,19,13,2073,64.8,fiu,3198
2006,143,UTEP,29,14,15,1876,64.7,utep,3431
2006,144,East Carolina,29,17,12,1874,64.6,east carolina,3187
2006,145,Notre Dame,30,18,12,1936,64.5,notre dame,3323
2006,146,Georgia Tech,29,14,15,1871,64.5,georgia tech,3210
2006,147,Ga. Southern,29,11,18,1870,64.5,ga. southern,3204
2006,148,UNC Asheville,28,15,13,1805,64.5,unc asheville,3421
2006,149,Drake,29,17,12,1868,64.4,drake,3179
2006,149,Dayton,29,17,12,1868,64.4,dayton,3173
2006,151,Delaware,30,22,8,1931,64.4,delaware,3174
2006,152,Loyola Marymount,29,17,12,1865,64.3,loyola marymount,3258
2006,153,Ohio,29,9,20,1864,64.3,ohio,3325
2006,154,George Washington,32,23,9,2055,64.2,george washington,3203
2006,155,Temple,32,24,8,2053,64.2,temple,3396
2006,156,Marist,30,23,7,1924,64.1,marist,3265
2006,157,UC Santa Barbara,30,16,14,1922,64.1,uc santa barbara,3364
2006,158,Coastal Caro.,28,18,10,1791,64,coastal caro.,3157
2006,158,Radford,28,14,14,1791,64,radford,3347
2006,160,Rutgers,32,27,5,2045,63.9,rutgers,3353
2006,161,UTSA,30,18,12,1917,63.9,utsa,3427
2006,162,Robert Morris,29,20,9,1853,63.9,robert morris,3352
2006,163,Oregon,29,14,15,1852,63.9,oregon,3332
2006,164,Louisiana,28,18,10,1788,63.9,se louisiana,3368
2006,165,Samford,29,21,8,1850,63.8,samford,3359
2006,166,Texas,28,13,15,1785,63.8,texas,3400
2006,167,VCU,28,13,15,1784,63.7,vcu,3433
2006,168,N.C. A&T,28,9,19,1782,63.6,n.c. a&t,3299
2006,169,UNLV,30,18,12,1909,63.6,unlv,3424
2006,170,Auburn,29,14,15,1845,63.6,auburn,3120
2006,171,Cornell,27,8,19,1717,63.6,cornell,3165
2006,172,Wright St.,28,12,16,1780,63.6,wright st.,3460
2006,173,La.-Monroe,29,18,11,1843,63.6,la.-monroe,3419
2006,174,Mississippi Val.,28,17,11,1777,63.5,mississippi val.,3290
2006,174,Fairleigh Dickinson,28,10,18,1777,63.5,fairleigh dickinson,3192
2006,176,Pepperdine,31,14,17,1966,63.4,pepperdine,3337
2006,177,Saint Peter's,28,13,15,1775,63.4,saint peter's,3389
2006,178,Toledo,29,11,18,1838,63.4,toledo,3405
2006,179,Creighton,29,8,21,1837,63.3,creighton,3166
2006,179,Marshall,29,15,14,1837,63.3,marshall,3267
2006,181,Missouri St.,32,17,15,2027,63.3,missouri st.,3283
2006,182,Gardner-Webb,30,14,16,1900,63.3,gardner-webb,3205
2006,183,Lehigh,28,10,18,1773,63.3,lehigh,3250
2006,183,Fort Wayne,28,7,21,1773,63.3,iupu-fort wayne,3236
2006,185,A&M-Corpus Christi,28,16,12,1771,63.3,a&m-corpus chris,3394
2006,186,Montana St.,26,3,23,1643,63.2,montana st.,3286
2006,187,Bucknell,29,18,11,1832,63.2,bucknell,3137
2006,188,Bradley,28,9,19,1766,63.1,bradley,3133
2006,189,Colgate,29,9,20,1829,63.1,colgate,3159
2006,190,Oregon St.,31,16,15,1953,63,oregon st.,3333
2006,190,Lamar University,27,11,16,1701,63,american university,3110
2006,192,Brown,28,18,10,1760,62.9,brown,3135
2006,193,Southern Ill.,28,10,18,1759,62.8,southern ill.,3356
2006,193,Portland,28,4,24,1759,62.8,portland,3339
2006,195,Holy Cross,30,16,14,1884,62.8,holy cross,3221
2006,196,Villanova,32,21,11,2009,62.8,villanova,3437
2006,197,Liberty,31,25,6,1944,62.7,liberty,3251
2006,198,Jacksonville,28,10,18,1754,62.6,jacksonville,3239
2006,199,Air Force,28,13,15,1753,62.6,air force,3102
2006,200,New Hampshire,28,15,13,1752,62.6,new hampshire,3306
2006,201,Georgia St.,29,9,20,1814,62.6,georgia st.,3209
2006,201,UT Arlington,29,20,9,1814,62.6,ut arlington,3426
2006,203,Illinois,31,16,15,1939,62.5,illinois,3228
2006,204,Miami (OH),28,8,20,1750,62.5,miami (oh),3275
2006,205,Jackson St.,31,17,14,1936,62.5,jackson st.,3238
2006,206,UNI,30,19,11,1870,62.3,uni,3320
2006,207,Monmouth,28,14,14,1745,62.3,monmouth,3284
2006,208,Siena,28,11,17,1744,62.3,siena,3373
2006,209,Wyoming,30,21,9,1864,62.1,wyoming,3461
2006,210,Fairfield,29,11,18,1797,62,fairfield,3193
2006,210,Hampton,29,7,22,1797,62,hampton,3214
2006,212,UMBC,28,15,13,1735,62,umbc,3420
2006,213,Idaho,29,10,19,1796,61.9,idaho,3225
2006,214,Pacific,28,6,22,1733,61.9,pacific,3334
2006,215,Richmond,30,13,17,1856,61.9,richmond,3350
2006,216,William & Mary,28,15,13,1732,61.9,william & mary,3456
2006,217,La Salle,28,11,17,1731,61.8,la salle,3247
2006,218,Indiana,33,19,14,2038,61.8,indiana,3231
2006,219,Vermont,27,9,18,1667,61.7,vermont,3436
2006,220,Eastern Wash.,28,13,15,1728,61.7,eastern wash.,3186
2006,221,Valparaiso,29,16,13,1789,61.7,valparaiso,3434
2006,222,Houston,29,12,17,1788,61.7,houston,3222
2006,223,Wofford,28,7,21,1718,61.4,wofford,3459
2006,224,Weber St.,30,15,15,1840,61.3,weber st.,3451
2006,224,Alcorn,27,11,16,1656,61.3,alcorn,3108
2006,226,Northern Ill.,29,12,17,1778,61.3,northern ill.,3296
2006,227,Saint Mary's (CA),28,12,16,1716,61.3,saint mary's (ca),3388
2006,228,Furman,30,10,20,1838,61.3,furman,3202
2006,229,Southern U.,31,20,11,1899,61.3,southern u.,3380
2006,230,San Diego,28,9,19,1714,61.2,san diego,3360
2006,231,McNeese,28,13,15,1713,61.2,mcneese st,3270
2006,232,San Jose St.,28,13,15,1710,61.1,san jose st.,3363
2006,233,Providence,27,8,19,1648,61,providence,3344
2006,234,Campbell,29,11,18,1767,60.9,campbell,3144
2006,235,Southern Utah,28,11,17,1706,60.9,southern utah,3381
2006,236,Troy,27,9,18,1644,60.9,troy,3407
2006,237,Loyola Chicago,29,4,25,1765,60.9,loyola chicago,3260
2006,238,Texas Southern,27,5,22,1642,60.8,texas southern,3411
2006,239,Western Ill.,30,23,7,1823,60.8,western ill.,3442
2006,240,Buffalo,28,10,18,1700,60.7,buffalo,3138
2006,240,South Carolina St.,28,13,15,1700,60.7,south carolina st.,3354
2006,242,Gonzaga,30,16,14,1820,60.7,gonzaga,3211
2006,243,Sacramento St.,26,9,17,1577,60.7,sacramento st.,3170
2006,244,Alabama,28,9,19,1696,60.6,alabama,3104
2006,245,LIU Brooklyn,29,14,15,1755,60.5,liu brooklyn,3254
2006,246,Maine,29,10,19,1751,60.4,maine,3263
2006,247,UC Riverside,31,16,15,1871,60.4,uc riverside,3415
2006,248,South Ala.,29,15,14,1750,60.3,south ala.,3375
2006,249,Syracuse,27,9,18,1624,60.1,syracuse,3393
2006,250,Morgan St.,28,5,23,1683,60.1,morgan st.,3288
2006,251,Northwestern,28,6,22,1680,60,northwestern,3321
2006,252,Saint Louis,27,7,20,1617,59.9,saint louis,3387
2006,253,IUPUI,28,17,11,1674,59.8,iupui,3237
2006,254,Memphis,28,3,25,1673,59.8,memphis,3272
2006,255,San Francisco,29,9,20,1729,59.6,san francisco,3362
2006,256,Washington St.,28,8,20,1669,59.6,washington st.,3450
2006,257,Saint Joseph's,31,20,11,1846,59.5,saint joseph's,3386
2006,258,Central Mich.,28,16,12,1667,59.5,central mich.,3141
2006,259,Duquesne,30,13,17,1782,59.4,duquesne,3182
2006,260,Northeastern,29,8,21,1721,59.3,northeastern,3318
2006,261,Birmingham-So.,28,12,16,1659,59.3,birmingham so,3128
2006,262,Delaware St.,30,21,9,1777,59.2,delaware st.,3175
2006,263,Georgetown,27,10,17,1598,59.2,georgetown,3207
2006,264,Mercer,29,14,15,1715,59.1,mercer,3273
2006,265,Norfolk St.,28,8,20,1653,59,norfolk st.,3313
2006,266,Col. of Charleston,28,11,17,1652,59,col. of charleston,3158
2006,267,Rhode Island,28,8,20,1650,58.9,rhode island,3348
2006,268,Manhattan,29,11,18,1708,58.9,manhattan,3264
2006,269,Nevada,30,13,17,1766,58.9,nevada,3305
2006,270,Denver,28,15,13,1644,58.7,denver,3176
2006,271,American,28,7,21,1643,58.7,american,3110
2006,272,UMKC,28,10,18,1641,58.6,umkc,3282
2006,273,Chicago St.,28,12,16,1640,58.6,chicago st.,3152
2006,273,Towson,28,9,19,1640,58.6,towson,3406
2006,275,Cleveland St.,28,4,24,1638,58.5,cleveland st.,3156
2006,276,Oklahoma St.,28,6,22,1635,58.4,oklahoma st.,3329
2006,277,Sam Houston St.,27,9,18,1575,58.3,sam houston st.,3358
2006,278,Coppin St.,31,22,9,1808,58.3,coppin st.,3164
2006,279,Youngstown St.,28,8,20,1633,58.3,youngstown st.,3464
2006,280,Lafayette,28,8,20,1631,58.3,lafayette,3248
2006,281,UCF,28,7,21,1625,58,ucf,3416
2006,282,Central Conn. St.,29,9,20,1682,58,central conn. st.,3148
2006,283,Alabama A&M,29,13,16,1681,58,alabama a&m,3105
2006,284,Drexel,29,15,14,1680,57.9,drexel,3180
2006,285,Alabama St.,30,15,15,1737,57.9,alabama st.,3106
2006,286,George Mason,29,12,17,1670,57.6,george mason,3206
2006,287,St. Bonaventure,27,9,18,1554,57.6,st. bonaventure,3382
2006,288,Little Rock,28,13,15,1609,57.5,little rock,3114
2006,289,Massachusetts,28,11,17,1607,57.4,massachusetts,3269
2006,290,Fordham,28,10,18,1606,57.4,fordham,3200
2006,290,Prairie View,28,7,21,1606,57.4,prairie view,3341
2006,292,Florida A&M,29,12,17,1661,57.3,florida a&m,3197
2006,293,UNCW,28,15,13,1602,57.2,unc,3314
2006,294,Michigan,29,6,23,1656,57.1,michigan,3276
2006,295,Columbia,27,6,21,1540,57,columbia,3162
2006,296,Mississippi St.,28,6,22,1589,56.8,mississippi st.,3280
2006,297,Winthrop,29,14,15,1641,56.6,winthrop,3457
2006,298,Southeastern La.,27,11,16,1523,56.4,southeastern la.,3368
2006,299,New Mexico St.,30,10,20,1689,56.3,new mexico st.,3308
2006,300,Tennessee St.,27,0,27,1520,56.3,tennessee st.,3398
2006,301,Wagner,27,2,25,1519,56.3,wagner,3447
2006,302,Penn,27,5,22,1516,56.1,penn,3335
2006,303,Ark.-Pine Bluff,28,7,21,1571,56.1,ark.-pine bluff,3115
2006,304,Centenary (LA),27,3,24,1513,56,centenary (la),3147
2006,305,Charleston So.,28,7,21,1566,55.9,charleston so.,3149
2006,306,Utah St.,27,3,24,1508,55.9,utah st.,3429
2006,307,Saint Francis (PA),28,4,24,1559,55.7,saint francis (pa),3384
2006,308,St. Francis Brooklyn,27,5,22,1502,55.6,st. francis brooklyn,3383
2006,309,UT Martin,27,8,19,1498,55.5,ut martin,3404
2006,310,Lipscomb,27,6,21,1496,55.4,lipscomb,3252
2006,311,Elon,28,12,16,1550,55.4,elon,3189
2006,312,Seton Hall,27,6,21,1485,55,seton hall,3371
2006,313,Stetson,28,9,19,1537,54.9,stetson,3391
2006,313,UTRGV,28,7,21,1537,54.9,utrgv,3410
2006,315,Akron,28,5,23,1528,54.6,akron,3103
2006,316,Niagara,29,4,25,1575,54.3,niagara,3310
2006,317,Albany (NY),28,7,21,1508,53.9,albany (ny),3107
2006,318,Bethune-Cookman,29,6,23,1553,53.6,bethune-cookman,3126
2006,319,Nicholls St.,27,4,23,1441,53.4,nicholls st.,3311
2006,320,San Diego St.,27,3,24,1435,53.1,san diego st.,3361
2006,321,Savannah St.,28,4,24,1480,52.9,savannah st.,3366
2006,322,Yale,27,3,24,1389,51.4,yale,3463
2006,323,New Orleans,28,3,25,1434,51.2,new orleans,3309
2006,324,Rider,28,3,25,1395,49.8,rider,3351
2007,1,North Carolina,38,34,4,3179,83.7,north carolina,3314
2007,2,Maryland,34,28,6,2810,82.6,maryland,3268
2007,3,Idaho St.,31,17,14,2465,79.5,idaho st.,3226
2007,4,Middle Tenn.,34,30,4,2692,79.2,middle tenn.,3292
2007,5,Ole Miss,35,24,11,2718,77.7,ole miss,3279
2007,6,Indiana St.,30,19,11,2329,77.6,indiana st.,3232
2007,7,Montana,31,27,4,2402,77.5,montana,3285
2007,8,UConn,36,32,4,2781,77.3,uconn,3163
2007,9,Oklahoma,33,28,5,2529,76.6,oklahoma,3328
2007,10,Vanderbilt,34,28,6,2595,76.3,vanderbilt,3435
2007,11,Green Bay,33,29,4,2509,76,green bay,3453
2007,12,Duke,34,32,2,2568,75.5,duke,3181
2007,13,Bowling Green,35,31,4,2604,74.4,bowling green,3132
2007,14,Baylor,34,26,8,2514,73.9,baylor,3124
2007,15,Tennessee,37,34,3,2724,73.6,tennessee,3397
2007,16,Louisville,35,27,8,2574,73.5,louisville,3257
2007,17,Robert Morris,32,24,8,2352,73.5,robert morris,3352
2007,18,DePaul,32,19,13,2344,73.3,depaul,3177
2007,19,Ball St.,31,24,7,2269,73.2,ball st.,3123
2007,20,Kent St.,28,15,13,2047,73.1,kent st.,3245
2007,21,Virginia,34,19,15,2473,72.7,virginia,3438
2007,22,Miami (OH),30,12,18,2181,72.7,miami (oh),3275
2007,23,TCU,32,21,11,2319,72.5,tcu,3395
2007,24,James Madison,33,27,6,2391,72.5,james madison,3241
2007,25,South Fla.,33,21,12,2390,72.4,south fla.,3378
2007,26,Arizona St.,36,31,5,2606,72.4,arizona st.,3113
2007,27,Ohio St.,32,28,4,2314,72.3,ohio st.,3326
2007,28,Northern Ill.,31,19,12,2241,72.3,northern ill.,3296
2007,29,Chattanooga,33,25,8,2379,72.1,chattanooga,3151
2007,30,Illinois St.,33,22,11,2377,72,illinois st.,3229
2007,31,Eastern Ill.,29,10,19,2085,71.9,eastern ill.,3183
2007,32,Evansville,31,19,12,2227,71.8,evansville,3191
2007,33,Western Ky.,32,23,9,2298,71.8,western ky.,3443
2007,34,Eastern Ky.,30,12,18,2154,71.8,eastern ky.,3184
2007,35,Georgia,34,27,7,2441,71.8,georgia,3208
2007,36,ETSU,32,20,12,2294,71.7,etsu,3190
2007,37,Washington,31,18,13,2215,71.5,washington,3449
2007,38,Stanford,34,29,5,2425,71.3,stanford,3390
2007,39,Murray St.,31,21,10,2210,71.3,murray st.,3293
2007,40,Nebraska,32,22,10,2280,71.3,nebraska,3304
2007,41,Tulane,33,26,7,2347,71.1,tulane,3408
2007,42,Oklahoma St.,31,20,11,2200,71,oklahoma st.,3329
2007,43,Charlotte,32,19,13,2270,70.9,charlotte,3150
2007,44,Marquette,33,26,7,2340,70.9,marquette,3266
2007,45,CSUN,29,13,16,2055,70.9,lsu,3261
2007,46,Davidson,32,23,9,2260,70.6,davidson,3172
2007,47,N.C. A&T,30,17,13,2115,70.5,n.c. a&t,3299
2007,48,Old Dominion,33,24,9,2325,70.5,old dominion,3330
2007,49,Wisconsin,36,23,13,2533,70.4,wisconsin,3458
2007,50,Kentucky,34,20,14,2392,70.4,kentucky,3246
2007,51,Saint Louis,30,13,17,2103,70.1,saint louis,3387
2007,52,Stony Brook,29,18,11,2032,70.1,stony brook,3392
2007,53,Notre Dame,32,20,12,2242,70.1,notre dame,3323
2007,54,Arkansas,31,18,13,2171,70,arkansas,3116
2007,55,Portland St.,30,12,18,2100,70,portland st.,3340
2007,56,Western Mich.,32,14,18,2238,69.9,western mich.,3444
2007,57,Missouri,31,17,14,2163,69.8,missouri,3281
2007,58,Purdue,37,31,6,2577,69.6,purdue,3345
2007,59,Rice,33,19,14,2298,69.6,rice,3349
2007,60,Xavier,34,26,8,2361,69.4,xavier,3462
2007,61,Western Caro.,34,24,10,2358,69.4,western caro.,3441
2007,62,Northern Ariz.,32,20,12,2214,69.2,northern ariz.,3319
2007,63,Clemson,30,12,18,2072,69.1,clemson,3155
2007,64,UAB,32,19,13,2210,69.1,uab,3412
2007,65,Auburn,34,21,13,2347,69,auburn,3120
2007,66,Boise St.,33,24,9,2275,68.9,boise st.,3129
2007,67,Delaware,32,26,6,2202,68.8,delaware,3174
2007,68,UC Santa Barbara,33,19,14,2270,68.8,uc santa barbara,3364
2007,69,UTEP,30,22,8,2063,68.8,utep,3431
2007,70,Butler,31,16,15,2130,68.7,butler,3139
2007,71,South Carolina,33,18,15,2265,68.6,south carolina,3376
2007,72,Florida,31,9,22,2127,68.6,florida,3196
2007,73,Santa Clara,30,13,17,2058,68.6,santa clara,3365
2007,74,Quinnipiac,28,16,12,1920,68.6,quinnipiac,3346
2007,75,Radford,31,20,11,2123,68.5,radford,3347
2007,76,Saint Mary's (CA),28,14,14,1917,68.5,saint mary's (ca),3388
2007,77,Gonzaga,34,24,10,2327,68.4,gonzaga,3211
2007,78,Eastern Mich.,29,16,13,1981,68.3,eastern mich.,3185
2007,79,Cincinnati,29,15,14,1980,68.3,cincinnati,3153
2007,80,Ill.-Chicago,32,19,13,2184,68.3,ill.-chicago,3227
2007,81,SMU,30,18,12,2046,68.2,smu,3374
2007,82,Jacksonville St.,29,7,22,1977,68.2,jacksonville st.,3240
2007,83,Wichita St.,29,9,20,1973,68,wichita st.,3455
2007,84,Ohio,30,18,12,2041,68,ohio,3325
2007,85,UNC Asheville,33,21,12,2242,67.9,unc asheville,3421
2007,86,Louisiana,34,25,9,2309,67.9,se louisiana,3368
2007,87,California,32,23,9,2173,67.9,california,3143
2007,88,Florida St.,34,24,10,2306,67.8,florida st.,3199
2007,89,Iowa St.,35,26,9,2373,67.8,iowa st.,3235
2007,89,Iowa,30,14,16,2034,67.8,iowa,3234
2007,91,UCLA,32,14,18,2169,67.8,ucla,3417
2007,91,Mississippi St.,32,18,14,2169,67.8,mississippi st.,3280
2007,93,Weber St.,31,17,14,2100,67.7,weber st.,3451
2007,94,Harvard,28,15,13,1896,67.7,harvard,3217
2007,95,Georgia St.,30,15,15,2031,67.7,georgia st.,3209
2007,96,Oral Roberts,33,22,11,2234,67.7,oral roberts,3331
2007,97,Eastern Wash.,29,10,19,1960,67.6,eastern wash.,3186
2007,98,Montana St.,29,13,16,1959,67.6,montana st.,3286
2007,99,Central Mich.,30,11,19,2026,67.5,central mich.,3141
2007,100,Appalachian St.,31,13,18,2093,67.5,appalachian st.,3111
2007,101,Marist,35,29,6,2359,67.4,marist,3265
2007,102,Indiana,33,19,14,2219,67.2,indiana,3231
2007,103,Loyola Chicago,28,7,21,1881,67.2,loyola chicago,3260
2007,104,George Washington,32,28,4,2148,67.1,george washington,3203
2007,104,Southeast Mo. St.,32,24,8,2148,67.1,southeast mo. st.,3369
2007,106,Temple,33,25,8,2215,67.1,temple,3396
2007,107,Nevada,32,17,15,2147,67.1,nevada,3305
2007,108,NC State,35,25,10,2344,67,nc state,3301
2007,109,Pittsburgh,33,24,9,2210,67,pittsburgh,3338
2007,110,Cal Poly,28,14,14,1871,66.8,cal poly,3142
2007,111,Minnesota,33,17,16,2204,66.8,minnesota,3278
2007,112,SFA,33,21,12,2203,66.8,utsa,3427
2007,113,Miami (FL),30,11,19,1999,66.6,miami (fl),3274
2007,114,Prairie View,33,19,14,2198,66.6,prairie view,3341
2007,115,Milwaukee,31,15,16,2061,66.5,milwaukee,3454
2007,116,UNCG,30,20,10,1990,66.3,unc,3314
2007,116,Texas St.,30,18,12,1990,66.3,texas st.,3402
2007,118,Wyoming,36,27,9,2387,66.3,wyoming,3461
2007,119,Arkansas St.,34,21,13,2254,66.3,arkansas st.,3117
2007,120,Southern California,30,17,13,1986,66.2,southern california,3425
2007,120,Jacksonville,30,21,9,1986,66.2,jacksonville,3239
2007,122,Hofstra,34,26,8,2249,66.1,hofstra,3220
2007,123,Georgia Tech,33,21,12,2182,66.1,georgia tech,3210
2007,124,Vermont,31,19,12,2048,66.1,vermont,3436
2007,125,Oakland,32,19,13,2114,66.1,oakland,3324
2007,126,Virginia Tech,34,19,15,2246,66.1,virginia tech,3439
2007,127,Liberty,31,19,12,2047,66,liberty,3251
2007,128,Fresno St.,31,18,13,2045,66,fresno st.,3201
2007,129,Louisiana Tech,30,17,13,1978,65.9,louisiana tech,3256
2007,130,LSU,38,30,8,2505,65.9,lsu,3261
2007,131,East Carolina,33,19,14,2173,65.8,east carolina,3187
2007,132,Fort Wayne,29,12,17,1906,65.7,iupu-fort wayne,3236
2007,133,Morehead St.,30,14,16,1971,65.7,morehead st.,3287
2007,134,A&M-Corpus Christi,31,15,16,2036,65.7,a&m-corpus chris,3394
2007,135,Saint Joseph's,33,19,14,2166,65.6,saint joseph's,3386
2007,136,Boston U.,30,15,15,1968,65.6,boston u.,3131
2007,137,Texas A&M,32,25,7,2099,65.6,texas a&m,3401
2007,138,New Mexico,33,24,9,2163,65.5,new mexico,3307
2007,139,UNI,30,17,13,1966,65.5,uni,3320
2007,140,Kansas St.,34,19,15,2220,65.3,kansas st.,3243
2007,141,Howard,30,8,22,1957,65.2,howard,3224
2007,142,Illinois,31,19,12,2020,65.2,illinois,3228
2007,143,Belmont,32,25,7,2084,65.1,belmont,3125
2007,144,Cal St. Fullerton,32,16,16,2083,65.1,cal st. fullerton,3168
2007,145,Sacred Heart,32,22,10,2080,65,sacred heart,3357
2007,145,Providence,29,13,16,1885,65,providence,3344
2007,147,UT Arlington,33,24,9,2141,64.9,ut arlington,3426
2007,148,Michigan St.,33,24,9,2139,64.8,michigan st.,3277
2007,149,Bradley,31,12,19,2004,64.6,bradley,3133
2007,150,Lamar University,30,13,17,1939,64.6,american university,3110
2007,151,Dayton,31,12,19,2003,64.6,dayton,3173
2007,152,Creighton,32,13,19,2067,64.6,creighton,3166
2007,153,San Diego,30,21,9,1934,64.5,san diego,3360
2007,154,Rutgers,36,27,9,2320,64.4,rutgers,3353
2007,155,Texas,32,18,14,2060,64.4,texas,3400
2007,156,Coppin St.,33,25,8,2119,64.2,coppin st.,3164
2007,157,Loyola Maryland,30,18,12,1926,64.2,loyola maryland,3259
2007,158,Grambling,31,12,19,1989,64.2,grambling,3212
2007,159,Army West Point,30,24,6,1923,64.1,armstrong,3118
2007,160,Southern Ill.,32,21,11,2048,64,southern ill.,3356
2007,160,VCU,30,17,13,1920,64,vcu,3433
2007,160,FIU,30,16,14,1920,64,fiu,3198
2007,163,Monmouth,31,18,13,1982,63.9,monmouth,3284
2007,164,La Salle,30,19,11,1917,63.9,la salle,3247
2007,165,Colorado,30,13,17,1916,63.9,colorado,3160
2007,166,Saint Francis (PA),29,7,22,1852,63.9,saint francis (pa),3384
2007,167,Texas Tech,31,15,16,1977,63.8,texas tech,3403
2007,168,Northwestern St.,30,10,20,1912,63.7,northwestern st.,3322
2007,169,West Virginia,32,21,11,2039,63.7,west virginia,3452
2007,170,Florida A&M,32,16,16,2038,63.7,florida a&m,3197
2007,171,Houston,28,9,19,1781,63.6,houston,3222
2007,172,Southern Miss.,30,15,15,1908,63.6,southern miss.,3379
2007,173,Penn St.,31,15,16,1970,63.5,penn st.,3336
2007,174,Tennessee Tech,30,12,18,1903,63.4,tennessee tech,3399
2007,175,Denver,31,20,11,1966,63.4,denver,3176
2007,175,LIU Brooklyn,31,22,9,1966,63.4,liu brooklyn,3254
2007,177,Toledo,30,11,19,1902,63.4,toledo,3405
2007,178,Yale,28,12,16,1773,63.3,yale,3463
2007,179,Birmingham-So.,30,8,22,1899,63.3,birmingham so,3128
2007,180,UC Irvine,30,6,24,1897,63.2,uc irvine,3414
2007,181,Marshall,30,15,15,1895,63.2,marshall,3267
2007,181,Fairfield,30,15,15,1895,63.2,fairfield,3193
2007,183,Princeton,28,13,15,1768,63.1,princeton,3343
2007,184,Arizona,32,11,21,2020,63.1,arizona,3112
2007,185,Fla. Atlantic,31,6,25,1954,63,fla. atlantic,3194
2007,186,Ga. Southern,31,13,18,1953,63,ga. southern,3204
2007,186,North Texas,29,9,20,1827,63,north texas,3317
2007,188,Niagara,30,14,16,1889,63,niagara,3310
2007,189,St. Bonaventure,31,16,15,1947,62.8,st. bonaventure,3382
2007,190,Oregon,31,17,14,1946,62.8,oregon,3332
2007,191,Massachusetts,30,17,13,1883,62.8,massachusetts,3269
2007,192,Hawaii,29,15,14,1820,62.8,hawaii,3218
2007,193,Coastal Caro.,29,18,11,1819,62.7,coastal caro.,3157
2007,194,Drake,33,14,19,2069,62.7,drake,3179
2007,195,Hampton,28,15,13,1753,62.6,hampton,3214
2007,196,Alabama A&M,30,17,13,1877,62.6,alabama a&m,3105
2007,197,Southeastern La.,30,17,13,1876,62.5,southeastern la.,3368
2007,198,Maine,28,13,15,1748,62.4,maine,3263
2007,199,Memphis,31,4,27,1934,62.4,memphis,3272
2007,200,Loyola Marymount,31,19,12,1932,62.3,loyola marymount,3258
2007,201,BYU,33,23,10,2056,62.3,byu,3140
2007,202,Little Rock,31,21,10,1929,62.2,little rock,3114
2007,203,Idaho,28,6,22,1742,62.2,idaho,3225
2007,204,Portland,30,10,20,1863,62.1,portland,3339
2007,205,Pepperdine,31,14,17,1925,62.1,pepperdine,3337
2007,206,Cleveland St.,30,8,22,1862,62.1,cleveland st.,3156
2007,207,Tulsa,30,11,19,1860,62,tulsa,3409
2007,208,Canisius,30,16,14,1858,61.9,canisius,3145
2007,209,Iona,34,21,13,2105,61.9,iona,3233
2007,210,Mt. St. Mary's,29,12,17,1791,61.8,mt. st. mary's,3291
2007,211,Samford,31,18,13,1913,61.7,samford,3359
2007,212,Valparaiso,31,20,11,1911,61.6,valparaiso,3434
2007,213,Missouri St.,28,7,21,1724,61.6,missouri st.,3283
2007,214,UTSA,30,14,16,1846,61.5,utsa,3427
2007,215,Austin Peay,30,10,20,1845,61.5,austin peay,3122
2007,216,Northeastern,30,4,26,1842,61.4,northeastern,3318
2007,217,Savannah St.,29,12,17,1780,61.4,savannah st.,3366
2007,218,UNLV,29,14,15,1779,61.3,unlv,3424
2007,219,UC Riverside,32,21,11,1961,61.3,uc riverside,3415
2007,220,Bucknell,31,20,11,1899,61.3,bucknell,3137
2007,221,Utah,33,19,14,2013,61,utah,3428
2007,221,Oregon St.,28,9,19,1708,61,oregon st.,3333
2007,223,High Point,30,18,12,1828,60.9,high point,3219
2007,224,Dartmouth,29,15,14,1763,60.8,dartmouth,3171
2007,224,Fairleigh Dickinson,29,11,18,1763,60.8,fairleigh dickinson,3192
2007,226,St. John's (NY),28,8,20,1701,60.8,st. john's (ny),3385
2007,227,New Mexico St.,31,13,18,1883,60.7,new mexico st.,3308
2007,228,Seton Hall,31,19,12,1881,60.7,seton hall,3371
2007,229,Jackson St.,33,22,11,2001,60.6,jackson st.,3238
2007,230,Troy,29,12,17,1758,60.6,troy,3407
2007,231,William & Mary,31,19,12,1879,60.6,william & mary,3456
2007,232,Richmond,30,13,17,1818,60.6,richmond,3350
2007,233,Campbell,29,8,21,1756,60.6,campbell,3144
2007,233,Sam Houston St.,29,5,24,1756,60.6,sam houston st.,3358
2007,235,Kansas,31,11,20,1875,60.5,kansas,3242
2007,236,Rhode Island,29,6,23,1754,60.5,rhode island,3348
2007,237,Tennessee St.,29,7,22,1753,60.4,tennessee st.,3398
2007,238,Chicago St.,29,9,20,1750,60.3,chicago st.,3152
2007,239,Alcorn,28,15,13,1689,60.3,alcorn,3108
2007,240,Wofford,29,13,16,1748,60.3,wofford,3459
2007,241,Alabama,30,10,20,1806,60.2,alabama,3104
2007,242,La.-Monroe,30,14,16,1804,60.1,la.-monroe,3419
2007,243,Boston College,29,13,16,1742,60.1,boston college,3130
2007,243,Akron,29,10,19,1742,60.1,akron,3103
2007,245,Towson,29,17,12,1740,60,towson,3406
2007,246,Pacific,30,8,22,1797,59.9,pacific,3334
2007,247,Saint Peter's,30,12,18,1792,59.7,saint peter's,3389
2007,248,Penn,27,12,15,1610,59.6,penn,3335
2007,249,Utah St.,29,11,18,1728,59.6,utah st.,3429
2007,250,St. Francis Brooklyn,31,13,18,1846,59.5,st. francis brooklyn,3383
2007,251,Buffalo,29,10,19,1725,59.5,buffalo,3138
2007,252,UT Martin,31,17,14,1843,59.5,ut martin,3404
2007,253,American,32,13,19,1899,59.3,american,3110
2007,254,Siena,30,10,20,1780,59.3,siena,3373
2007,255,UMBC,33,16,17,1955,59.2,umbc,3420
2007,256,Ark.-Pine Bluff,31,11,20,1831,59.1,ark.-pine bluff,3115
2007,257,Central Conn. St.,29,6,23,1712,59,central conn. st.,3148
2007,258,Charleston So.,30,10,20,1771,59,charleston so.,3149
2007,259,Duquesne,27,7,20,1593,59,duquesne,3182
2007,259,Cornell,27,12,15,1593,59,cornell,3165
2007,261,Colorado St.,29,8,21,1710,59,colorado st.,3161
2007,262,Nicholls St.,27,7,20,1592,59,nicholls st.,3311
2007,263,Morgan St.,31,18,13,1825,58.9,morgan st.,3288
2007,264,Detroit Mercy,31,5,26,1824,58.8,detroit mercy,3178
2007,265,Binghamton,31,12,19,1821,58.7,binghamton,3127
2007,266,Hartford,34,25,9,1994,58.6,hartford,3216
2007,267,San Francisco,31,10,21,1817,58.6,san francisco,3362
2007,268,Norfolk St.,30,6,24,1757,58.6,norfolk st.,3313
2007,269,Syracuse,29,9,20,1696,58.5,syracuse,3393
2007,269,Georgetown,29,13,16,1696,58.5,georgetown,3207
2007,271,San Jose St.,32,5,27,1870,58.4,san jose st.,3363
2007,272,Wright St.,28,10,18,1636,58.4,wright st.,3460
2007,273,IUPUI,30,14,16,1745,58.2,iupui,3237
2007,274,Northwestern,30,8,22,1744,58.1,northwestern,3321
2007,275,Rider,30,2,28,1740,58,rider,3351
2007,276,UCF,30,8,22,1736,57.9,ucf,3416
2007,277,Mississippi Val.,28,7,21,1620,57.9,mississippi val.,3290
2007,278,Holy Cross,33,15,18,1906,57.8,holy cross,3221
2007,279,Columbia,28,8,20,1617,57.8,columbia,3162
2007,280,George Mason,29,8,21,1674,57.7,george mason,3206
2007,281,New Orleans,30,9,21,1729,57.6,new orleans,3309
2007,282,Lipscomb,29,8,21,1668,57.5,lipscomb,3252
2007,283,Col. of Charleston,30,10,20,1723,57.4,col. of charleston,3158
2007,284,South Ala.,30,14,16,1721,57.4,south ala.,3375
2007,285,Drexel,31,10,21,1774,57.2,drexel,3180
2007,286,Alabama St.,30,12,18,1715,57.2,alabama st.,3106
2007,287,Youngstown St.,28,7,21,1597,57,youngstown st.,3464
2007,288,New Hampshire,29,9,20,1650,56.9,new hampshire,3306
2007,289,Michigan,30,10,20,1705,56.8,michigan,3276
2007,290,Lafayette,30,7,23,1700,56.7,lafayette,3248
2007,291,UTRGV,29,11,18,1643,56.7,utrgv,3410
2007,292,Delaware St.,33,20,13,1867,56.6,delaware st.,3175
2007,293,Lehigh,30,11,19,1696,56.5,lehigh,3250
2007,294,Centenary (LA),30,5,25,1695,56.5,centenary (la),3147
2007,295,Wake Forest,29,9,20,1638,56.5,wake forest,3448
2007,296,Washington St.,29,5,24,1637,56.4,washington st.,3450
2007,297,Furman,31,11,20,1748,56.4,furman,3202
2007,298,Manhattan,31,11,20,1747,56.4,manhattan,3264
2007,299,Stetson,30,5,25,1688,56.3,stetson,3391
2007,300,San Diego St.,28,12,16,1572,56.1,san diego st.,3361
2007,301,UMKC,30,10,20,1683,56.1,umkc,3282
2007,302,Albany (NY),31,9,22,1734,55.9,albany (ny),3107
2007,303,Villanova,29,8,21,1619,55.8,villanova,3437
2007,304,Long Beach St.,32,9,23,1786,55.8,long beach st.,3253
2007,305,McNeese,29,4,25,1608,55.4,mcneese st,3270
2007,306,South Carolina St.,29,7,22,1601,55.2,south carolina st.,3354
2007,307,UNCW,31,8,23,1705,55,unc,3314
2007,308,Navy,29,12,17,1590,54.8,navy,3298
2007,309,Brown,28,5,23,1529,54.6,brown,3135
2007,310,Gardner-Webb,31,14,17,1687,54.4,gardner-webb,3205
2007,311,Western Ill.,29,10,19,1575,54.3,western ill.,3442
2007,312,Winthrop,32,6,26,1733,54.2,winthrop,3457
2007,313,Sacramento St.,30,3,27,1621,54,sacramento st.,3170
2007,314,Wagner,29,3,26,1564,53.9,wagner,3447
2007,315,Air Force,29,6,23,1555,53.6,air force,3102
2007,316,UMES,31,11,20,1661,53.6,umes,3271
2007,317,Colgate,31,6,25,1646,53.1,colgate,3159
2007,318,Elon,30,10,20,1565,52.2,elon,3189
2007,319,Southern U.,27,5,22,1395,51.7,southern u.,3380
2007,320,Texas Southern,27,5,22,1386,51.3,texas southern,3411
2007,321,Southern Utah,29,9,20,1483,51.1,southern utah,3381
2007,322,Fordham,28,3,25,1427,51,fordham,3200
2007,323,Bethune-Cookman,30,5,25,1492,49.7,bethune-cookman,3126
2007,324,Mercer,30,5,25,1432,47.7,mercer,3273
2008,1,North Carolina,36,33,3,3107,86.3,north carolina,3314
2008,2,Maryland,37,33,4,3035,82,maryland,3268
2008,3,UConn,38,36,2,3086,81.2,uconn,3163
2008,4,DePaul,32,20,12,2487,77.7,depaul,3177
2008,5,Gonzaga,34,25,9,2625,77.2,gonzaga,3211
2008,6,Illinois St.,33,26,7,2537,76.9,illinois st.,3229
2008,7,Tennessee,38,36,2,2916,76.7,tennessee,3397
2008,8,Notre Dame,34,25,9,2591,76.2,notre dame,3323
2008,9,Texas St.,32,21,11,2428,75.9,texas st.,3402
2008,10,Oklahoma St.,35,27,8,2645,75.6,oklahoma st.,3329
2008,11,Portland St.,31,22,9,2339,75.5,portland st.,3340
2008,12,Old Dominion,36,31,5,2708,75.2,old dominion,3330
2008,13,N.C. A&T,33,25,8,2479,75.1,n.c. a&t,3299
2008,14,ETSU,33,21,12,2478,75.1,etsu,3190
2008,15,Stanford,39,35,4,2928,75.1,stanford,3390
2008,16,Louisville,36,26,10,2695,74.9,louisville,3257
2008,17,Montana,32,25,7,2392,74.8,montana,3285
2008,18,Virginia,34,24,10,2540,74.7,virginia,3438
2008,19,Idaho St.,30,20,10,2236,74.5,idaho st.,3226
2008,20,Western Caro.,34,25,9,2518,74.1,western caro.,3441
2008,21,Murray St.,32,24,8,2360,73.8,murray st.,3293
2008,22,Western Ky.,34,26,8,2493,73.3,western ky.,3443
2008,23,SMU,33,24,9,2417,73.2,smu,3374
2008,24,Middle Tenn.,34,22,12,2490,73.2,middle tenn.,3292
2008,25,Montana St.,31,18,13,2268,73.2,montana st.,3286
2008,26,Green Bay,32,26,6,2338,73.1,green bay,3453
2008,27,Robert Morris,33,23,10,2408,73,robert morris,3352
2008,28,Oklahoma,31,22,9,2259,72.9,oklahoma,3328
2008,29,Boise St.,32,24,8,2330,72.8,boise st.,3129
2008,30,Baylor,32,25,7,2316,72.4,baylor,3124
2008,31,Oakland,30,20,10,2166,72.2,oakland,3324
2008,32,Bowling Green,34,26,8,2451,72.1,bowling green,3132
2008,33,Fresno St.,33,22,11,2378,72.1,fresno st.,3201
2008,34,James Madison,34,24,10,2449,72,james madison,3241
2008,35,Eastern Ky.,28,14,14,2014,71.9,eastern ky.,3184
2008,36,Liberty,32,28,4,2293,71.7,liberty,3251
2008,37,Marist,35,32,3,2502,71.5,marist,3265
2008,38,UTEP,32,28,4,2286,71.4,utep,3431
2008,39,Southern Miss.,35,21,14,2498,71.4,southern miss.,3379
2008,40,Miami (OH),34,23,11,2426,71.4,miami (oh),3275
2008,41,Duke,35,25,10,2491,71.2,duke,3181
2008,42,TCU,35,23,12,2490,71.1,tcu,3395
2008,43,Syracuse,31,22,9,2205,71.1,syracuse,3393
2008,44,Vanderbilt,34,25,9,2416,71.1,vanderbilt,3435
2008,45,Ohio St.,31,22,9,2200,71,ohio st.,3326
2008,46,Ohio,33,20,13,2331,70.6,ohio,3325
2008,47,Iona,34,20,14,2401,70.6,iona,3233
2008,48,Wisconsin,30,16,14,2114,70.5,wisconsin,3458
2008,49,Pittsburgh,35,24,11,2465,70.4,pittsburgh,3338
2008,50,Georgia Tech,32,22,10,2251,70.3,georgia tech,3210
2008,51,Marquette,35,21,14,2460,70.3,marquette,3266
2008,52,Western Mich.,32,13,19,2248,70.3,western mich.,3444
2008,53,Nebraska,33,21,12,2307,69.9,nebraska,3304
2008,54,Texas,35,22,13,2442,69.8,texas,3400
2008,55,Saint Mary's (CA),32,15,17,2231,69.7,saint mary's (ca),3388
2008,56,Chattanooga,33,29,4,2297,69.6,chattanooga,3151
2008,57,Evansville,33,21,12,2296,69.6,evansville,3191
2008,58,Portland,30,15,15,2086,69.5,portland,3339
2008,59,Pacific,30,14,16,2083,69.4,pacific,3334
2008,60,Boston U.,32,20,12,2220,69.4,boston u.,3131
2008,61,West Virginia,33,25,8,2285,69.2,west virginia,3452
2008,62,LSU,37,31,6,2561,69.2,lsu,3261
2008,63,Florida St.,33,19,14,2283,69.2,florida st.,3199
2008,64,Santa Clara,31,20,11,2144,69.2,santa clara,3365
2008,65,Georgia,33,23,10,2282,69.2,georgia,3208
2008,66,Auburn,32,20,12,2211,69.1,auburn,3120
2008,67,Quinnipiac,31,25,6,2138,69,quinnipiac,3346
2008,68,UC Santa Barbara,31,23,8,2137,68.9,uc santa barbara,3364
2008,69,UTSA,33,23,10,2273,68.9,utsa,3427
2008,70,Utah,32,27,5,2199,68.7,utah,3428
2008,71,UCF,30,10,20,2057,68.6,ucf,3416
2008,72,Indiana St.,29,14,15,1984,68.4,indiana st.,3232
2008,73,Florida,33,19,14,2257,68.4,florida,3196
2008,74,Louisiana Tech,31,16,15,2120,68.4,louisiana tech,3256
2008,75,UT Arlington,29,19,10,1982,68.3,ut arlington,3426
2008,76,San Diego,32,19,13,2187,68.3,san diego,3360
2008,77,San Francisco,30,14,16,2049,68.3,san francisco,3362
2008,78,UAB,30,14,16,2047,68.2,uab,3412
2008,79,Nevada,30,18,12,2043,68.1,nevada,3305
2008,80,Marshall,33,17,16,2244,68,marshall,3267
2008,81,New Mexico St.,32,23,9,2169,67.8,new mexico st.,3308
2008,82,Jacksonville,32,23,9,2167,67.7,jacksonville,3239
2008,83,Houston,31,15,16,2097,67.6,houston,3222
2008,84,Pepperdine,28,10,18,1893,67.6,pepperdine,3337
2008,85,Coppin St.,34,22,12,2296,67.5,coppin st.,3164
2008,86,Kansas St.,32,22,10,2159,67.5,kansas st.,3243
2008,87,Creighton,33,21,12,2225,67.4,creighton,3166
2008,88,Duquesne,30,15,15,2022,67.4,duquesne,3182
2008,89,Indiana,33,18,15,2223,67.4,indiana,3231
2008,90,George Washington,34,27,7,2290,67.4,george washington,3203
2008,91,Northwestern St.,30,15,15,2018,67.3,northwestern st.,3322
2008,92,Prairie View,34,22,12,2287,67.3,prairie view,3341
2008,93,Ball St.,30,15,15,2017,67.2,ball st.,3123
2008,94,East Carolina,30,13,17,2016,67.2,east carolina,3187
2008,94,Southern Ill.,30,10,20,2016,67.2,southern ill.,3356
2008,94,Fort Wayne,30,12,18,2016,67.2,iupu-fort wayne,3236
2008,97,UCLA,31,16,15,2083,67.2,ucla,3417
2008,98,Drake,34,23,11,2284,67.2,drake,3179
2008,99,Milwaukee,31,17,14,2082,67.2,milwaukee,3454
2008,100,Colorado,34,19,15,2283,67.1,colorado,3160
2008,101,UMES,30,17,13,2014,67.1,umes,3271
2008,102,Minnesota,32,20,12,2145,67,minnesota,3278
2008,103,Vermont,33,24,9,2209,66.9,vermont,3436
2008,104,Radford,35,23,12,2341,66.9,radford,3347
2008,105,Texas Tech,33,17,16,2207,66.9,texas tech,3403
2008,106,Virginia Tech,30,15,15,2006,66.9,virginia tech,3439
2008,107,Cal Poly,32,13,19,2137,66.8,cal poly,3142
2008,108,Missouri St.,30,11,19,2001,66.7,missouri st.,3283
2008,109,Oral Roberts,33,19,14,2197,66.6,oral roberts,3331
2008,110,NC State,34,21,13,2261,66.5,nc state,3301
2008,111,Memphis,30,10,20,1994,66.5,memphis,3272
2008,112,Central Mich.,29,6,23,1923,66.3,central mich.,3141
2008,113,Valparaiso,30,14,16,1989,66.3,valparaiso,3434
2008,114,Cleveland St.,33,19,14,2186,66.2,cleveland st.,3156
2008,115,Mississippi St.,31,16,15,2051,66.2,mississippi st.,3280
2008,116,Eastern Ill.,32,19,13,2117,66.2,eastern ill.,3183
2008,117,Dayton,34,25,9,2239,65.9,dayton,3173
2008,118,Texas A&M,37,29,8,2434,65.8,texas a&m,3401
2008,119,Gardner-Webb,31,13,18,2039,65.8,gardner-webb,3205
2008,120,Jacksonville St.,30,11,19,1973,65.8,jacksonville st.,3240
2008,121,Tennessee St.,30,13,17,1972,65.7,tennessee st.,3398
2008,122,Morgan St.,31,19,12,2037,65.7,morgan st.,3288
2008,123,Iowa,32,21,11,2102,65.7,iowa,3234
2008,124,Charlotte,32,18,14,2101,65.7,charlotte,3150
2008,125,South Carolina,32,16,16,2100,65.6,south carolina,3376
2008,125,South Fla.,32,16,16,2100,65.6,south fla.,3378
2008,127,Saint Louis,30,10,20,1968,65.6,saint louis,3387
2008,127,Arkansas,30,17,13,1968,65.6,arkansas,3116
2008,129,St. John's (NY),33,18,15,2164,65.6,st. john's (ny),3385
2008,130,Butler,30,20,10,1966,65.5,butler,3139
2008,131,UC Davis,31,19,12,2031,65.5,uc davis,3413
2008,132,VCU,34,26,8,2227,65.5,vcu,3433
2008,133,North Texas,32,14,18,2093,65.4,north texas,3317
2008,134,Tulane,30,16,14,1962,65.4,tulane,3408
2008,135,Eastern Mich.,29,17,12,1893,65.3,eastern mich.,3185
2008,136,Harvard,29,18,11,1891,65.2,harvard,3217
2008,137,Arizona St.,33,22,11,2151,65.2,arizona st.,3113
2008,138,Cornell,29,20,9,1889,65.1,cornell,3165
2008,139,San Diego St.,31,18,13,2015,65,san diego st.,3361
2008,140,Davidson,30,19,11,1949,65,davidson,3172
2008,141,Loyola Marymount,30,15,15,1942,64.7,loyola marymount,3258
2008,142,Northern Colo.,30,14,16,1940,64.7,northern colo.,3294
2008,143,Ole Miss,29,13,16,1874,64.6,ole miss,3279
2008,144,UC Irvine,31,7,24,2003,64.6,uc irvine,3414
2008,145,Howard,30,4,26,1937,64.6,howard,3224
2008,146,California,34,27,7,2195,64.6,california,3143
2008,147,Hartford,34,28,6,2191,64.4,hartford,3216
2008,148,Manhattan,30,15,15,1932,64.4,manhattan,3264
2008,149,Chicago St.,29,16,13,1865,64.3,chicago st.,3152
2008,150,UNC Asheville,30,12,18,1927,64.2,unc asheville,3421
2008,151,High Point,30,15,15,1925,64.2,high point,3219
2008,152,Hawaii,30,12,18,1923,64.1,hawaii,3218
2008,153,Siena,29,11,18,1857,64,siena,3373
2008,154,Youngstown St.,31,14,17,1982,63.9,youngstown st.,3464
2008,155,Boston College,33,21,12,2109,63.9,boston college,3130
2008,156,SFA,29,12,17,1853,63.9,utsa,3427
2008,157,Lamar University,32,19,13,2043,63.8,american university,3110
2008,158,Wyoming,31,24,7,1979,63.8,wyoming,3461
2008,159,Xavier,33,24,9,2106,63.8,xavier,3462
2008,160,Samford,32,23,9,2041,63.8,samford,3359
2008,161,Southeastern La.,29,12,17,1848,63.7,southeastern la.,3368
2008,162,Saint Peter's,31,19,12,1974,63.7,saint peter's,3389
2008,163,Hampton,31,18,13,1973,63.6,hampton,3214
2008,164,Yale,27,9,18,1717,63.6,yale,3463
2008,165,Washington,31,13,18,1971,63.6,washington,3449
2008,166,La.-Monroe,30,17,13,1905,63.5,la.-monroe,3419
2008,167,Northern Ariz.,30,10,20,1904,63.5,northern ariz.,3319
2008,168,Bradley,30,12,18,1901,63.4,bradley,3133
2008,169,Penn St.,31,13,18,1964,63.4,penn st.,3336
2008,170,Kent St.,30,9,21,1894,63.1,kent st.,3245
2008,171,Northeastern,30,14,16,1891,63,northeastern,3318
2008,171,Cal St. Fullerton,30,11,19,1891,63,cal st. fullerton,3168
2008,173,Arkansas St.,32,20,12,2016,63,arkansas st.,3117
2008,174,Appalachian St.,30,8,22,1887,62.9,appalachian st.,3111
2008,175,Massachusetts,30,13,17,1886,62.9,massachusetts,3269
2008,176,South Carolina St.,30,13,17,1885,62.8,south carolina st.,3354
2008,177,Eastern Wash.,29,4,25,1821,62.8,eastern wash.,3186
2008,178,Ark.-Pine Bluff,31,12,19,1946,62.8,ark.-pine bluff,3115
2008,179,Sacred Heart,30,19,11,1883,62.8,sacred heart,3357
2008,180,Monmouth,31,11,20,1945,62.7,monmouth,3284
2008,181,Michigan St.,37,23,14,2320,62.7,michigan st.,3277
2008,182,New Mexico,33,20,13,2068,62.7,new mexico,3307
2008,183,Northern Ill.,28,10,18,1754,62.6,northern ill.,3296
2008,184,Southern California,30,17,13,1879,62.6,southern california,3425
2008,185,Richmond,31,14,17,1929,62.2,richmond,3350
2008,186,Cincinnati,28,12,16,1742,62.2,cincinnati,3153
2008,187,Georgetown,29,15,14,1804,62.2,georgetown,3207
2008,188,Illinois,35,20,15,2177,62.2,illinois,3228
2008,189,UNCW,31,17,14,1928,62.2,unc,3314
2008,190,UMKC,31,11,20,1927,62.2,umkc,3282
2008,190,Akron,31,7,24,1927,62.2,akron,3103
2008,192,Iowa St.,34,21,13,2113,62.1,iowa st.,3235
2008,193,Buffalo,30,15,15,1864,62.1,buffalo,3138
2008,194,Southeast Mo. St.,32,23,9,1985,62,southeast mo. st.,3369
2008,195,Winthrop,32,20,12,1982,61.9,winthrop,3457
2008,196,Albany (NY),31,13,18,1920,61.9,albany (ny),3107
2008,197,UC Riverside,30,14,16,1858,61.9,uc riverside,3415
2008,198,William & Mary,32,14,18,1981,61.9,william & mary,3456
2008,199,Clemson,31,12,19,1919,61.9,clemson,3155
2008,200,Arizona,30,10,20,1857,61.9,arizona,3112
2008,201,Alabama A&M,28,14,14,1733,61.9,alabama a&m,3105
2008,202,Rice,32,14,18,1979,61.8,rice,3349
2008,203,Fairfield,31,22,9,1915,61.8,fairfield,3193
2008,204,Belmont,30,14,16,1851,61.7,belmont,3125
2008,205,Toledo,30,14,16,1850,61.7,toledo,3405
2008,206,Saint Joseph's,31,17,14,1911,61.6,saint joseph's,3386
2008,207,LIU Brooklyn,32,24,8,1970,61.6,liu brooklyn,3254
2008,207,Towson,32,22,10,1970,61.6,towson,3406
2008,209,Florida A&M,31,14,17,1908,61.5,florida a&m,3197
2008,210,Weber St.,28,12,16,1720,61.4,weber st.,3451
2008,211,Ga. Southern,30,17,13,1841,61.4,ga. southern,3204
2008,212,Kentucky,33,17,16,2024,61.3,kentucky,3246
2008,213,Niagara,30,8,22,1839,61.3,niagara,3310
2008,214,Binghamton,30,11,19,1833,61.1,binghamton,3127
2008,215,Rutgers,34,27,7,2074,61,rutgers,3353
2008,215,Villanova,33,17,16,2013,61,villanova,3437
2008,217,Wofford,31,10,21,1890,61,wofford,3459
2008,218,Loyola Chicago,31,8,23,1887,60.9,loyola chicago,3260
2008,219,Tennessee Tech,30,8,22,1825,60.8,tennessee tech,3399
2008,219,Mississippi Val.,30,14,16,1825,60.8,mississippi val.,3290
2008,221,St. Bonaventure,30,18,12,1822,60.7,st. bonaventure,3382
2008,222,Kansas,33,17,16,2003,60.7,kansas,3242
2008,223,Sacramento St.,28,6,22,1699,60.7,sacramento st.,3170
2008,224,Furman,30,10,20,1820,60.7,furman,3202
2008,225,Seton Hall,28,13,15,1697,60.6,seton hall,3371
2008,226,South Ala.,31,20,11,1873,60.4,south ala.,3375
2008,227,Troy,31,13,18,1872,60.4,troy,3407
2008,228,Longwood,29,16,13,1750,60.3,longwood,3255
2008,229,Miami (FL),30,9,21,1810,60.3,miami (fl),3274
2008,229,Princeton,30,7,23,1810,60.3,princeton,3343
2008,231,Canisius,31,13,18,1869,60.3,canisius,3145
2008,232,Little Rock,32,23,9,1928,60.3,little rock,3114
2008,233,UNI,31,13,18,1865,60.2,uni,3320
2008,234,American,32,18,14,1924,60.1,american,3110
2008,235,Nicholls St.,27,6,21,1623,60.1,nicholls st.,3311
2008,236,Columbia,28,10,18,1682,60.1,columbia,3162
2008,237,FIU,31,13,18,1862,60.1,fiu,3198
2008,238,Western Ill.,30,14,16,1798,59.9,western ill.,3442
2008,239,Oregon St.,31,12,19,1857,59.9,oregon st.,3333
2008,240,Alabama St.,30,12,18,1796,59.9,alabama st.,3106
2008,241,Coastal Caro.,28,16,12,1676,59.9,coastal caro.,3157
2008,242,Drexel,30,18,12,1795,59.8,drexel,3180
2008,243,Bucknell,32,16,16,1912,59.8,bucknell,3137
2008,244,Lipscomb,32,10,22,1910,59.7,lipscomb,3252
2008,245,Wright St.,32,16,16,1909,59.7,wright st.,3460
2008,246,Temple,34,21,13,2028,59.6,temple,3396
2008,247,San Jose St.,31,3,28,1849,59.6,san jose st.,3363
2008,248,Elon,32,12,20,1908,59.6,elon,3189
2008,249,Louisiana,30,8,22,1788,59.6,se louisiana,3368
2008,250,UNLV,30,8,22,1787,59.6,unlv,3424
2008,251,Michigan,33,19,14,1963,59.5,michigan,3276
2008,252,New Orleans,30,13,17,1782,59.4,new orleans,3309
2008,253,Providence,29,12,17,1721,59.3,providence,3344
2008,254,Long Beach St.,29,9,20,1720,59.3,long beach st.,3253
2008,255,McNeese,31,10,21,1838,59.3,mcneese st,3270
2008,256,Morehead St.,30,11,19,1778,59.3,morehead st.,3287
2008,257,Norfolk St.,28,5,23,1658,59.2,norfolk st.,3313
2008,257,Fla. Atlantic,28,6,22,1658,59.2,fla. atlantic,3194
2008,259,Denver,30,11,19,1775,59.2,denver,3176
2008,260,Rider,30,8,22,1772,59.1,rider,3351
2008,261,Purdue,34,19,15,2008,59.1,purdue,3345
2008,262,Ill.-Chicago,30,10,20,1769,59,ill.-chicago,3227
2008,263,Charleston So.,30,8,22,1767,58.9,charleston so.,3149
2008,264,UMBC,30,9,21,1766,58.9,umbc,3420
2008,265,Army West Point,30,18,12,1762,58.7,armstrong,3118
2008,265,Campbell,30,12,18,1762,58.7,campbell,3144
2008,267,Oregon,31,14,17,1814,58.5,oregon,3332
2008,268,New Hampshire,29,7,22,1695,58.4,new hampshire,3306
2008,269,Missouri,31,10,21,1810,58.4,missouri,3281
2008,270,Utah St.,29,9,20,1693,58.4,utah st.,3429
2008,271,Holy Cross,32,19,13,1868,58.4,holy cross,3221
2008,272,Tulsa,31,11,20,1808,58.3,tulsa,3409
2008,273,Jackson St.,32,18,14,1864,58.3,jackson st.,3238
2008,274,Loyola Maryland,30,13,17,1747,58.2,loyola maryland,3259
2008,275,UTRGV,29,11,18,1685,58.1,utrgv,3410
2008,276,A&M-Corpus Christi,32,12,20,1854,57.9,a&m-corpus chris,3394
2008,277,Mercer,30,4,26,1738,57.9,mercer,3273
2008,278,La Salle,29,12,17,1680,57.9,la salle,3247
2008,279,Mt. St. Mary's,30,8,22,1737,57.9,mt. st. mary's,3291
2008,279,Lafayette,30,14,16,1737,57.9,lafayette,3248
2008,281,IUPUI,33,17,16,1910,57.9,iupui,3237
2008,282,Savannah St.,29,14,15,1676,57.8,savannah st.,3366
2008,283,Fairleigh Dickinson,30,13,17,1727,57.6,fairleigh dickinson,3192
2008,284,Georgia St.,30,8,22,1725,57.5,georgia st.,3209
2008,285,Austin Peay,29,6,23,1664,57.4,austin peay,3122
2008,286,Maine,30,7,23,1721,57.4,maine,3263
2008,287,Delaware St.,32,18,14,1834,57.3,delaware st.,3175
2008,288,Col. of Charleston,30,14,16,1718,57.3,col. of charleston,3158
2008,289,Rhode Island,31,13,18,1773,57.2,rhode island,3348
2008,290,Stony Brook,31,8,23,1752,56.5,stony brook,3392
2008,291,Wake Forest,30,15,15,1694,56.5,wake forest,3448
2008,292,Sam Houston St.,29,1,28,1635,56.4,sam houston st.,3358
2008,293,CSUN,27,1,26,1519,56.3,lsu,3261
2008,294,Penn,29,7,22,1629,56.2,penn,3335
2008,295,Alcorn,30,12,18,1680,56,alcorn,3108
2008,295,Air Force,29,10,19,1624,56,air force,3102
2008,297,Centenary (LA),29,4,25,1623,56,centenary (la),3147
2008,298,Grambling,28,2,26,1566,55.9,grambling,3212
2008,299,Southern U.,28,12,16,1561,55.8,southern u.,3380
2008,300,Hofstra,30,5,25,1672,55.7,hofstra,3220
2008,301,Lehigh,31,18,13,1717,55.4,lehigh,3250
2008,302,Central Conn. St.,29,4,25,1598,55.1,central conn. st.,3148
2008,303,St. Francis Brooklyn,30,10,20,1652,55.1,st. francis brooklyn,3383
2008,304,Saint Francis (PA),29,6,23,1596,55,saint francis (pa),3384
2008,305,Alabama,30,8,22,1646,54.9,alabama,3104
2008,306,Wichita St.,31,9,22,1699,54.8,wichita st.,3455
2008,307,George Mason,30,9,21,1644,54.8,george mason,3206
2008,308,Wagner,29,7,22,1584,54.6,wagner,3447
2008,309,Stetson,30,9,21,1635,54.5,stetson,3391
2008,310,Dartmouth,31,15,16,1684,54.3,dartmouth,3171
2008,311,Detroit Mercy,30,6,24,1622,54.1,detroit mercy,3178
2008,312,Idaho,29,4,25,1567,54,idaho,3225
2008,313,Colorado St.,32,4,28,1729,54,colorado st.,3161
2008,314,UT Martin,30,5,25,1618,53.9,ut martin,3404
2008,315,Bethune-Cookman,30,6,24,1617,53.9,bethune-cookman,3126
2008,316,BYU,29,13,16,1558,53.7,byu,3140
2008,317,UNCG,31,7,24,1647,53.1,unc,3314
2008,318,Texas Southern,28,8,20,1480,52.9,texas southern,3411
2008,319,Northwestern,31,5,26,1637,52.8,northwestern,3321
2008,320,Navy,30,7,23,1570,52.3,navy,3298
2008,321,Washington St.,30,5,25,1553,51.8,washington st.,3450
2008,322,Fordham,29,0,29,1500,51.7,fordham,3200
2008,323,Southern Utah,30,6,24,1519,50.6,southern utah,3381
2008,324,Delaware,31,7,24,1569,50.6,delaware,3174
2008,325,Brown,28,2,26,1322,47.2,brown,3135
2008,326,Colgate,30,1,29,1341,44.7,colgate,3159
2009,1,UConn,39,39,0,3274,83.9,uconn,3163
2009,2,North Carolina,35,28,7,2894,82.7,north carolina,3314
2009,3,Maryland,36,31,5,2844,79,maryland,3268
2009,4,Central Mich.,32,18,14,2505,78.3,central mich.,3141
2009,5,South Fla.,37,27,10,2886,78,south fla.,3378
2009,6,Auburn,34,30,4,2602,76.5,auburn,3120
2009,7,N.C. A&T,33,26,7,2523,76.5,n.c. a&t,3299
2009,8,Middle Tenn.,34,28,6,2598,76.4,middle tenn.,3292
2009,9,Murray St.,32,23,9,2444,76.4,murray st.,3293
2009,10,Stanford,38,33,5,2893,76.1,stanford,3390
2009,11,Oklahoma,37,32,5,2803,75.8,oklahoma,3328
2009,12,Gonzaga,34,27,7,2534,74.5,gonzaga,3211
2009,13,Montana St.,30,15,15,2224,74.1,montana st.,3286
2009,14,Florida,32,24,8,2366,73.9,florida,3196
2009,15,Bowling Green,34,29,5,2508,73.8,bowling green,3132
2009,16,South Dakota St.,35,32,3,2558,73.1,south dakota st.,3355
2009,17,Pittsburgh,33,25,8,2410,73,pittsburgh,3338
2009,18,UT Arlington,33,22,11,2408,73,ut arlington,3426
2009,19,Southern California,32,17,15,2334,72.9,southern california,3425
2009,20,Virginia,34,24,10,2476,72.8,virginia,3438
2009,21,Marist,33,29,4,2398,72.7,marist,3265
2009,22,Illinois St.,35,27,8,2539,72.5,illinois st.,3229
2009,23,Boston U.,33,25,8,2385,72.3,boston u.,3131
2009,24,Duke,33,27,6,2379,72.1,duke,3181
2009,25,Vanderbilt,35,26,9,2516,71.9,vanderbilt,3435
2009,26,Ball St.,35,26,9,2504,71.5,ball st.,3123
2009,27,Notre Dame,31,22,9,2216,71.5,notre dame,3323
2009,28,Kent St.,29,19,10,2070,71.4,kent st.,3245
2009,29,Syracuse,32,17,15,2282,71.3,syracuse,3393
2009,30,DePaul,33,23,10,2352,71.3,depaul,3177
2009,31,Louisville,39,34,5,2767,70.9,louisville,3257
2009,32,East Carolina,31,18,13,2193,70.7,east carolina,3187
2009,33,Oklahoma St.,33,17,16,2333,70.7,oklahoma st.,3329
2009,34,ETSU,31,20,11,2183,70.4,etsu,3190
2009,35,Boston College,35,23,12,2458,70.2,boston college,3130
2009,36,Texas,33,21,12,2316,70.2,texas,3400
2009,37,Florida St.,34,26,8,2386,70.2,florida st.,3199
2009,38,Portland St.,33,23,10,2314,70.1,portland st.,3340
2009,39,Tennessee,33,22,11,2306,69.9,tennessee,3397
2009,40,Chattanooga,32,22,10,2226,69.6,chattanooga,3151
2009,41,UMBC,30,14,16,2083,69.4,umbc,3420
2009,42,Montana,33,28,5,2291,69.4,montana,3285
2009,43,Arizona St.,35,26,9,2428,69.4,arizona st.,3113
2009,44,Baylor,35,29,6,2427,69.3,baylor,3124
2009,45,UTSA,33,24,9,2287,69.3,utsa,3427
2009,46,Louisiana Tech,34,21,13,2355,69.3,louisiana tech,3256
2009,47,TCU,31,20,11,2145,69.2,tcu,3395
2009,48,Oakland,33,26,7,2283,69.2,oakland,3324
2009,48,Sacred Heart,33,25,8,2283,69.2,sacred heart,3357
2009,50,Charleston So.,30,12,18,2074,69.1,charleston so.,3149
2009,51,Southern Miss.,32,20,12,2211,69.1,southern miss.,3379
2009,52,Bradley,31,21,10,2140,69,bradley,3133
2009,53,Ohio St.,35,29,6,2415,69,ohio st.,3326
2009,53,Duquesne,32,20,12,2208,69,duquesne,3182
2009,55,James Madison,34,24,10,2345,69,james madison,3241
2009,56,UCF,34,17,17,2344,68.9,ucf,3416
2009,57,Loyola Marymount,30,18,12,2063,68.8,loyola marymount,3258
2009,58,San Diego,32,19,13,2194,68.6,san diego,3360
2009,59,Harvard,29,19,10,1987,68.5,harvard,3217
2009,60,SMU,32,20,12,2192,68.5,smu,3374
2009,61,Western Caro.,33,21,12,2255,68.3,western caro.,3441
2009,62,Fresno St.,33,24,9,2251,68.2,fresno st.,3201
2009,63,Texas A&M,35,27,8,2387,68.2,texas a&m,3401
2009,64,Mississippi St.,33,23,10,2245,68,mississippi st.,3280
2009,65,Iowa,32,21,11,2176,68,iowa,3234
2009,66,Western Ky.,29,16,13,1962,67.7,western ky.,3443
2009,67,Kansas,36,22,14,2435,67.6,kansas,3242
2009,68,Eastern Ill.,33,24,9,2231,67.6,eastern ill.,3183
2009,69,Charlotte,32,23,9,2163,67.6,charlotte,3150
2009,70,Sam Houston St.,29,9,20,1958,67.5,sam houston st.,3358
2009,71,Saint Francis (PA),32,15,17,2159,67.5,saint francis (pa),3384
2009,72,Houston,29,19,10,1954,67.4,houston,3222
2009,73,Indiana,32,21,11,2154,67.3,indiana,3231
2009,74,Lehigh,33,26,7,2220,67.3,lehigh,3250
2009,75,Georgia Tech,32,22,10,2152,67.3,georgia tech,3210
2009,76,Northern Ill.,30,15,15,2017,67.2,northern ill.,3296
2009,77,Northwestern St.,31,18,13,2082,67.2,northwestern st.,3322
2009,78,California,34,27,7,2283,67.1,california,3143
2009,79,Morehead St.,31,17,14,2081,67.1,morehead st.,3287
2009,80,Ole Miss,33,18,15,2212,67,ole miss,3279
2009,81,Tennessee St.,31,18,13,2077,67,tennessee st.,3398
2009,82,VCU,33,26,7,2202,66.7,vcu,3433
2009,83,Temple,31,21,10,2068,66.7,temple,3396
2009,84,Arkansas,32,18,14,2133,66.7,arkansas,3116
2009,85,UCLA,31,19,12,2065,66.6,ucla,3417
2009,86,Vermont,33,21,12,2198,66.6,vermont,3436
2009,87,Mercer,31,17,14,2064,66.6,mercer,3273
2009,88,UTEP,30,18,12,1997,66.6,utep,3431
2009,89,Lamar University,31,20,11,2063,66.5,american university,3110
2009,90,Xavier,32,25,7,2128,66.5,xavier,3462
2009,91,North Texas,31,11,20,2060,66.5,north texas,3317
2009,92,Old Dominion,30,17,13,1992,66.4,old dominion,3330
2009,93,Toledo,31,18,13,2052,66.2,toledo,3405
2009,94,Saint Mary's (CA),30,11,19,1984,66.1,saint mary's (ca),3388
2009,95,Cal Poly,32,21,11,2110,65.9,cal poly,3142
2009,96,Green Bay,33,29,4,2175,65.9,green bay,3453
2009,97,Oral Roberts,30,13,17,1975,65.8,oral roberts,3331
2009,98,South Ala.,32,21,11,2103,65.7,south ala.,3375
2009,99,High Point,31,15,16,2035,65.6,high point,3219
2009,100,Miami (FL),30,13,17,1969,65.6,miami (fl),3274
2009,101,Wake Forest,31,19,12,2033,65.6,wake forest,3448
2009,102,Prairie View,34,23,11,2229,65.6,prairie view,3341
2009,103,Miami (OH),31,16,15,2032,65.5,miami (oh),3275
2009,104,Austin Peay,33,17,16,2163,65.5,austin peay,3122
2009,105,Seton Hall,31,17,14,2030,65.5,seton hall,3371
2009,106,Texas St.,28,12,16,1833,65.5,texas st.,3402
2009,107,West Virginia,33,18,15,2160,65.5,west virginia,3452
2009,108,New Mexico,36,25,11,2356,65.4,new mexico,3307
2009,109,Hartford,32,20,12,2092,65.4,hartford,3216
2009,110,Davidson,30,12,18,1961,65.4,davidson,3172
2009,111,Marshall,32,17,15,2090,65.3,marshall,3267
2009,112,Canisius,33,24,9,2150,65.2,canisius,3145
2009,113,Purdue,36,25,11,2345,65.1,purdue,3345
2009,114,Columbia,28,13,15,1821,65,columbia,3162
2009,115,Marquette,33,17,16,2146,65,marquette,3266
2009,116,Southeastern La.,30,19,11,1949,65,southeastern la.,3368
2009,117,Central Conn. St.,32,18,14,2078,64.9,central conn. st.,3148
2009,118,Col. of Charleston,31,23,8,2013,64.9,col. of charleston,3158
2009,119,Saint Louis,30,12,18,1945,64.8,saint louis,3387
2009,120,Quinnipiac,29,18,11,1880,64.8,quinnipiac,3346
2009,121,American,31,19,12,2009,64.8,american,3110
2009,122,San Diego St.,32,24,8,2064,64.5,san diego st.,3361
2009,123,Cleveland St.,32,19,13,2063,64.5,cleveland st.,3156
2009,124,Tulane,32,18,14,2061,64.4,tulane,3408
2009,125,Northern Colo.,30,12,18,1932,64.4,northern colo.,3294
2009,126,Clemson,31,14,17,1996,64.4,clemson,3155
2009,127,St. John's (NY),34,19,15,2187,64.3,st. john's (ny),3385
2009,128,Buffalo,32,8,24,2058,64.3,buffalo,3138
2009,129,SFA,29,15,14,1864,64.3,utsa,3427
2009,130,Dayton,35,21,14,2248,64.2,dayton,3173
2009,131,Iowa St.,36,27,9,2312,64.2,iowa st.,3235
2009,132,Georgetown,34,20,14,2183,64.2,georgetown,3207
2009,133,George Washington,31,17,14,1986,64.1,george washington,3203
2009,134,UNLV,32,14,18,2050,64.1,unlv,3424
2009,135,Pacific,30,14,16,1920,64,pacific,3334
2009,136,Georgia,32,18,14,2047,64,georgia,3208
2009,137,Penn St.,29,11,18,1855,64,penn st.,3336
2009,138,Eastern Wash.,29,10,19,1854,63.9,eastern wash.,3186
2009,139,St. Bonaventure,34,23,11,2170,63.8,st. bonaventure,3382
2009,140,Robert Morris,31,13,18,1978,63.8,robert morris,3352
2009,141,Arkansas St.,30,16,14,1914,63.8,arkansas st.,3117
2009,142,Texas Tech,31,16,15,1975,63.7,texas tech,3403
2009,143,Valparaiso,30,16,14,1910,63.7,valparaiso,3434
2009,144,Gardner-Webb,32,17,15,2036,63.6,gardner-webb,3205
2009,145,Iona,31,18,13,1971,63.6,iona,3233
2009,146,Michigan St.,33,22,11,2097,63.5,michigan st.,3277
2009,147,Oregon St.,32,20,12,2032,63.5,oregon st.,3333
2009,148,Alabama,30,13,17,1904,63.5,alabama,3104
2009,149,Hampton,32,16,16,2030,63.4,hampton,3214
2009,150,Western Mich.,30,7,23,1903,63.4,western mich.,3444
2009,151,Bethune-Cookman,29,12,17,1839,63.4,bethune-cookman,3126
2009,152,Saint Joseph's,30,13,17,1902,63.4,saint joseph's,3386
2009,153,Ohio,31,13,18,1965,63.4,ohio,3325
2009,154,Massachusetts,30,12,18,1898,63.3,massachusetts,3269
2009,155,Kentucky,32,16,16,2024,63.3,kentucky,3246
2009,156,Rutgers,34,21,13,2147,63.1,rutgers,3353
2009,157,Tennessee Tech,30,9,21,1894,63.1,tennessee tech,3399
2009,157,Missouri St.,30,10,20,1894,63.1,missouri st.,3283
2009,159,Kansas St.,33,25,8,2082,63.1,kansas st.,3243
2009,159,Utah,33,23,10,2082,63.1,utah,3428
2009,161,Nevada,32,18,14,2018,63.1,nevada,3305
2009,162,Morgan St.,30,17,13,1891,63,morgan st.,3288
2009,163,Butler,32,20,12,2017,63,butler,3139
2009,164,Chicago St.,29,16,13,1823,62.9,chicago st.,3152
2009,164,Eastern Mich.,29,8,21,1823,62.9,eastern mich.,3185
2009,166,La.-Monroe,31,15,16,1943,62.7,la.-monroe,3419
2009,167,Liberty,33,24,9,2068,62.7,liberty,3251
2009,168,Cal St. Fullerton,30,10,20,1876,62.5,cal st. fullerton,3168
2009,169,Weber St.,29,10,19,1813,62.5,weber st.,3451
2009,170,Wofford,29,5,24,1810,62.4,wofford,3459
2009,171,Minnesota,32,20,12,1994,62.3,minnesota,3278
2009,172,Yale,28,11,17,1742,62.2,yale,3463
2009,173,Virginia Tech,30,12,18,1866,62.2,virginia tech,3439
2009,174,Denver,31,16,15,1928,62.2,denver,3176
2009,175,McNeese,30,14,16,1865,62.2,mcneese st,3270
2009,175,Sacramento St.,30,9,21,1865,62.2,sacramento st.,3170
2009,177,Nebraska,31,15,16,1927,62.2,nebraska,3304
2009,178,Furman,30,12,18,1862,62.1,furman,3202
2009,179,Fla. Atlantic,29,12,17,1799,62,fla. atlantic,3194
2009,180,Milwaukee,33,15,18,2045,62,milwaukee,3454
2009,181,Ark.-Pine Bluff,30,12,19,1858,61.9,ark.-pine bluff,3115
2009,182,Manhattan,30,10,20,1857,61.9,manhattan,3264
2009,183,Troy,30,16,14,1854,61.8,troy,3407
2009,183,Georgia St.,30,12,18,1854,61.8,georgia st.,3209
2009,185,Boise St.,31,16,15,1914,61.7,boise st.,3129
2009,186,Memphis,30,12,18,1852,61.7,memphis,3272
2009,187,Idaho St.,31,11,20,1910,61.6,idaho st.,3226
2009,188,UMKC,30,12,18,1847,61.6,umkc,3282
2009,189,Jacksonville,32,19,13,1970,61.6,jacksonville,3239
2009,190,Evansville,34,15,19,2093,61.6,evansville,3191
2009,191,Drake,31,19,12,1908,61.5,drake,3179
2009,192,Richmond,34,24,10,2092,61.5,richmond,3350
2009,193,Drexel,33,24,9,2029,61.5,drexel,3180
2009,194,Little Rock,33,26,7,2028,61.5,little rock,3114
2009,195,William & Mary,31,14,17,1896,61.2,william & mary,3456
2009,196,Long Beach St.,29,8,21,1772,61.1,long beach st.,3253
2009,197,Portland,31,17,14,1894,61.1,portland,3339
2009,198,Belmont,31,18,13,1893,61.1,belmont,3125
2009,199,South Carolina St.,29,6,23,1768,61,south carolina st.,3354
2009,200,Samford,29,22,7,1766,60.9,samford,3359
2009,201,Ill.-Chicago,30,14,16,1826,60.9,ill.-chicago,3227
2009,202,New Mexico St.,31,9,22,1885,60.8,new mexico st.,3308
2009,203,Hofstra,30,16,14,1824,60.8,hofstra,3220
2009,204,Colorado,29,11,18,1763,60.8,colorado,3160
2009,205,Holy Cross,30,13,17,1822,60.7,holy cross,3221
2009,206,Pepperdine,29,16,13,1761,60.7,pepperdine,3337
2009,207,Princeton,28,14,14,1700,60.7,princeton,3343
2009,208,Loyola Chicago,29,8,21,1759,60.7,loyola chicago,3260
2009,209,Southern Utah,29,9,20,1758,60.6,southern utah,3381
2009,210,Missouri,30,13,17,1818,60.6,missouri,3281
2009,211,Northern Ariz.,30,9,21,1813,60.4,northern ariz.,3319
2009,212,NC State,30,13,17,1812,60.4,nc state,3301
2009,213,UMES,29,15,14,1751,60.4,umes,3271
2009,214,A&M-Corpus Christi,30,11,19,1811,60.4,a&m-corpus chris,3394
2009,215,UNI,30,11,19,1809,60.3,uni,3320
2009,216,Fairfield,31,18,13,1869,60.3,fairfield,3193
2009,217,UAB,30,10,20,1808,60.3,uab,3412
2009,218,UNCW,31,16,15,1868,60.3,unc,3314
2009,219,North Dakota St.,29,16,13,1746,60.2,north dakota st.,3295
2009,220,Binghamton,31,14,17,1866,60.2,binghamton,3127
2009,221,Fort Wayne,30,9,21,1805,60.2,iupu-fort wayne,3236
2009,222,Southeast Mo. St.,30,15,15,1802,60.1,southeast mo. st.,3369
2009,223,Florida A&M,31,14,17,1862,60.1,florida a&m,3197
2009,224,Southern Ill.,28,9,19,1681,60,southern ill.,3356
2009,225,Creighton,34,22,12,2040,60,creighton,3166
2009,225,IUPUI,31,16,15,1860,60,iupui,3237
2009,227,Wichita St.,31,13,18,1858,59.9,wichita st.,3455
2009,228,Wyoming,30,16,14,1795,59.8,wyoming,3461
2009,229,LSU,30,19,11,1794,59.8,lsu,3261
2009,230,Siena,28,10,18,1674,59.8,siena,3373
2009,231,CSUN,31,8,23,1853,59.8,lsu,3261
2009,232,UNC Asheville,30,10,20,1791,59.7,unc asheville,3421
2009,233,Washington St.,30,11,19,1787,59.6,washington st.,3450
2009,233,Rider,30,10,20,1787,59.6,rider,3351
2009,235,Akron,30,11,19,1786,59.5,akron,3103
2009,236,UC Santa Barbara,32,22,10,1905,59.5,uc santa barbara,3364
2009,237,Rice,30,7,23,1783,59.4,rice,3349
2009,238,Appalachian St.,31,9,22,1840,59.4,appalachian st.,3111
2009,239,Stetson,30,8,22,1777,59.2,stetson,3391
2009,240,Cincinnati,31,14,17,1836,59.2,cincinnati,3153
2009,241,Ga. Southern,30,16,14,1774,59.1,ga. southern,3204
2009,242,Colorado St.,31,10,21,1833,59.1,colorado st.,3161
2009,243,Bucknell,28,16,12,1651,59,bucknell,3137
2009,244,UC Riverside,31,19,12,1827,58.9,uc riverside,3415
2009,245,Washington,30,8,22,1768,58.9,washington,3449
2009,246,Idaho,28,13,15,1649,58.9,idaho,3225
2009,247,Towson,30,17,13,1761,58.7,towson,3406
2009,248,New Orleans,31,14,17,1818,58.6,new orleans,3309
2009,249,Jackson St.,28,8,20,1637,58.5,jackson st.,3238
2009,250,Coastal Caro.,30,16,14,1748,58.3,coastal caro.,3157
2009,251,Utah St.,31,16,15,1806,58.3,utah st.,3429
2009,252,Saint Peter's,28,13,15,1631,58.3,saint peter's,3389
2009,253,Providence,30,10,20,1745,58.2,providence,3344
2009,254,Indiana St.,30,14,16,1743,58.1,indiana st.,3232
2009,255,UC Davis,29,11,18,1684,58.1,uc davis,3413
2009,256,Navy,31,16,15,1799,58,navy,3298
2009,257,Mt. St. Mary's,30,14,16,1740,58,mt. st. mary's,3291
2009,258,South Carolina,28,10,18,1622,57.9,south carolina,3376
2009,259,Jacksonville St.,30,7,23,1735,57.8,jacksonville st.,3240
2009,260,BYU,29,18,11,1677,57.8,byu,3140
2009,261,Wagner,29,7,22,1673,57.7,wagner,3447
2009,262,Arizona,31,12,19,1786,57.6,arizona,3112
2009,263,Loyola Maryland,30,10,20,1726,57.5,loyola maryland,3259
2009,264,Hawaii,31,8,23,1782,57.5,hawaii,3218
2009,265,UNCG,31,13,18,1780,57.4,unc,3314
2009,266,Longwood,29,8,21,1661,57.3,longwood,3255
2009,266,San Francisco,29,7,22,1661,57.3,san francisco,3362
2009,268,Detroit Mercy,31,12,19,1774,57.2,detroit mercy,3178
2009,269,Albany (NY),31,6,25,1773,57.2,albany (ny),3107
2009,270,La Salle,29,10,19,1656,57.1,la salle,3247
2009,271,Campbell,30,12,18,1712,57.1,campbell,3144
2009,272,Northeastern,31,12,19,1767,57,northeastern,3318
2009,272,Radford,28,10,18,1596,57,radford,3347
2009,274,Northwestern,30,7,23,1708,56.9,northwestern,3321
2009,275,Eastern Ky.,27,7,20,1537,56.9,eastern ky.,3184
2009,276,Oregon,30,9,21,1699,56.6,oregon,3332
2009,277,Dartmouth,29,18,11,1642,56.6,dartmouth,3171
2009,278,Wisconsin,34,19,15,1924,56.6,wisconsin,3458
2009,279,Lipscomb,30,6,24,1695,56.5,lipscomb,3252
2009,280,Mississippi Val.,32,13,19,1799,56.2,mississippi val.,3290
2009,281,Coppin St.,29,14,15,1630,56.2,coppin st.,3164
2009,281,Centenary (LA),29,4,25,1630,56.2,centenary (la),3147
2009,283,Fairleigh Dickinson,30,10,20,1685,56.2,fairleigh dickinson,3192
2009,284,Wright St.,31,15,16,1741,56.2,wright st.,3460
2009,285,Cornell,26,10,16,1460,56.2,cornell,3165
2009,286,Penn,28,9,19,1572,56.1,penn,3335
2009,287,Stony Brook,29,6,23,1628,56.1,stony brook,3392
2009,288,Monmouth,31,18,13,1739,56.1,monmouth,3284
2009,289,Lafayette,32,10,22,1791,56,lafayette,3248
2009,290,Elon,31,5,26,1733,55.9,elon,3189
2009,291,Niagara,31,3,28,1732,55.9,niagara,3310
2009,292,Grambling,29,8,21,1620,55.9,grambling,3212
2009,293,Southern U.,30,16,14,1675,55.8,southern u.,3380
2009,294,Tulsa,29,7,22,1611,55.6,tulsa,3409
2009,295,Delaware,30,15,15,1666,55.5,delaware,3174
2009,296,Winthrop,32,16,16,1773,55.4,winthrop,3457
2009,297,Michigan,30,10,20,1662,55.4,michigan,3276
2009,298,Norfolk St.,28,1,27,1551,55.4,norfolk st.,3313
2009,299,UTRGV,30,14,16,1660,55.3,utrgv,3410
2009,300,New Hampshire,31,8,23,1714,55.3,new hampshire,3306
2009,301,Alabama A&M,29,11,18,1595,55,alabama a&m,3105
2009,302,Army West Point,31,19,12,1702,54.9,armstrong,3118
2009,303,Louisiana,30,3,27,1647,54.9,se louisiana,3368
2009,304,Villanova,33,19,14,1810,54.8,villanova,3437
2009,305,Rhode Island,31,10,21,1673,54,rhode island,3348
2009,306,LIU Brooklyn,29,9,20,1564,53.9,liu brooklyn,3254
2009,307,Alabama St.,30,14,16,1610,53.7,alabama st.,3106
2009,308,FIU,30,6,24,1606,53.5,fiu,3198
2009,309,Delaware St.,30,15,15,1601,53.4,delaware st.,3175
2009,310,Howard,31,9,22,1651,53.3,howard,3224
2009,311,Western Ill.,30,9,21,1595,53.2,western ill.,3442
2009,312,St. Francis Brooklyn,29,4,25,1541,53.1,st. francis brooklyn,3383
2009,313,Santa Clara,31,4,27,1642,53,santa clara,3365
2009,314,Fordham,29,8,21,1533,52.9,fordham,3200
2009,315,Illinois,31,10,21,1638,52.8,illinois,3228
2009,316,Nicholls St.,27,2,25,1424,52.7,nicholls st.,3311
2009,317,George Mason,30,4,26,1570,52.3,george mason,3206
2009,318,San Jose St.,30,2,28,1567,52.2,san jose st.,3363
2009,319,UT Martin,29,2,27,1510,52.1,ut martin,3404
2009,320,Maine,30,5,25,1560,52,maine,3263
2009,321,Colgate,30,5,25,1515,50.5,colgate,3159
2009,322,Youngstown St.,30,3,27,1505,50.2,youngstown st.,3464
2009,323,Texas Southern,30,10,20,1504,50.1,texas southern,3411
2009,324,Alcorn,31,5,26,1546,49.9,alcorn,3108
2009,325,Savannah St.,31,9,22,1536,49.5,savannah st.,3366
2009,326,UC Irvine,30,7,23,1484,49.5,uc irvine,3414
2009,327,Brown,28,3,25,1382,49.4,brown,3135
2009,328,Air Force,30,4,26,1452,48.4,air force,3102
2010,1,Oral Roberts,33,23,10,2807,85.1,oral roberts,3331
2010,2,Oregon,34,18,16,2767,81.4,oregon,3332
2010,3,UConn,39,39,0,3162,81.1,uconn,3163
2010,4,Middle Tenn.,31,25,6,2506,80.8,middle tenn.,3292
2010,5,Gonzaga,34,29,5,2719,80,gonzaga,3211
2010,6,Sacramento St.,30,15,15,2374,79.1,sacramento st.,3170
2010,7,SFA,29,18,11,2270,78.3,utsa,3427
2010,8,Ohio St.,36,31,5,2807,78,ohio st.,3326
2010,9,ETSU,32,23,9,2491,77.8,etsu,3190
2010,10,Nebraska,34,32,2,2632,77.4,nebraska,3304
2010,11,Notre Dame,35,29,6,2701,77.2,notre dame,3323
2010,12,North Carolina,31,19,12,2371,76.5,north carolina,3314
2010,13,Stanford,38,36,2,2891,76.1,stanford,3390
2010,14,Missouri St.,33,22,11,2510,76.1,missouri st.,3283
2010,15,Texas A&M,34,26,8,2567,75.5,texas a&m,3401
2010,16,Lamar University,34,26,8,2549,75,american university,3110
2010,17,Miami (FL),36,22,14,2693,74.8,miami (fl),3274
2010,18,Tennessee,35,32,3,2600,74.3,tennessee,3397
2010,19,Kentucky,36,28,8,2662,73.9,kentucky,3246
2010,20,Louisiana Tech,32,23,9,2363,73.8,louisiana tech,3256
2010,21,Florida St.,35,29,6,2582,73.8,florida st.,3199
2010,22,South Dakota St.,33,22,11,2430,73.6,south dakota st.,3355
2010,23,Texas,33,22,11,2424,73.5,texas,3400
2010,24,Bowling Green,34,27,7,2495,73.4,bowling green,3132
2010,25,Fresno St.,34,27,7,2479,72.9,fresno st.,3201
2010,26,Oklahoma St.,35,24,11,2542,72.6,oklahoma st.,3329
2010,27,TCU,31,22,9,2235,72.1,tcu,3395
2010,28,Montana St.,32,18,14,2306,72.1,montana st.,3286
2010,29,Xavier,34,30,4,2445,71.9,xavier,3462
2010,29,N.C. A&T,34,23,11,2445,71.9,n.c. a&t,3299
2010,31,Eastern Mich.,31,22,9,2227,71.8,eastern mich.,3185
2010,32,Cal Poly,29,18,11,2081,71.8,cal poly,3142
2010,33,Oklahoma,38,27,11,2725,71.7,oklahoma,3328
2010,34,Sam Houston St.,29,11,18,2078,71.7,sam houston st.,3358
2010,35,Central Mich.,30,12,18,2149,71.6,central mich.,3141
2010,36,Syracuse,36,25,11,2574,71.5,syracuse,3393
2010,37,East Carolina,34,23,11,2430,71.5,east carolina,3187
2010,38,Green Bay,33,28,5,2355,71.4,green bay,3453
2010,39,Ole Miss,32,17,15,2282,71.3,ole miss,3279
2010,40,Dayton,33,25,8,2350,71.2,dayton,3173
2010,41,James Madison,33,26,7,2337,70.8,james madison,3241
2010,42,Mississippi St.,34,21,13,2405,70.7,mississippi st.,3280
2010,43,Murray St.,30,13,17,2122,70.7,murray st.,3293
2010,44,Princeton,29,26,3,2051,70.7,princeton,3343
2010,45,Duke,36,30,6,2537,70.5,duke,3181
2010,46,Boise St.,31,19,12,2181,70.4,boise st.,3129
2010,47,Baylor,37,27,10,2603,70.4,baylor,3124
2010,48,St. John's (NY),32,25,7,2247,70.2,st. john's (ny),3385
2010,49,Houston,32,17,15,2244,70.1,houston,3222
2010,50,Maryland,34,21,13,2380,70,maryland,3268
2010,51,Eastern Ill.,34,23,11,2376,69.9,eastern ill.,3183
2010,52,Virginia,31,21,10,2160,69.7,virginia,3438
2010,53,Vanderbilt,34,23,11,2368,69.6,vanderbilt,3435
2010,54,Tulane,33,26,7,2296,69.6,tulane,3408
2010,55,Northwestern St.,31,15,16,2156,69.5,northwestern st.,3322
2010,56,Iowa,34,20,14,2359,69.4,iowa,3234
2010,57,A&M-Corpus Christi,35,24,11,2427,69.3,a&m-corpus chris,3394
2010,58,Saint Mary's (CA),31,21,10,2143,69.1,saint mary's (ca),3388
2010,59,Toledo,34,25,9,2350,69.1,toledo,3405
2010,60,Illinois St.,36,28,8,2485,69,illinois st.,3229
2010,61,Boston College,32,17,15,2208,69,boston college,3130
2010,62,Portland,31,18,13,2134,68.8,portland,3339
2010,63,VCU,35,22,13,2409,68.8,vcu,3433
2010,64,Harvard,29,20,9,1993,68.7,harvard,3217
2010,65,Saint Francis (PA),32,17,15,2197,68.7,saint francis (pa),3384
2010,66,Morehead St.,33,22,11,2264,68.6,morehead st.,3287
2010,67,Gardner-Webb,33,28,5,2263,68.6,gardner-webb,3205
2010,68,LSU,31,21,10,2124,68.5,lsu,3261
2010,69,Western Ky.,32,21,11,2190,68.4,western ky.,3443
2010,70,Oakland,30,17,13,2053,68.4,oakland,3324
2010,71,New Mexico St.,32,18,14,2188,68.4,new mexico st.,3308
2010,72,Pittsburgh,31,16,15,2119,68.4,pittsburgh,3338
2010,73,DePaul,33,21,12,2254,68.3,depaul,3177
2010,74,LIU Brooklyn,32,22,10,2178,68.1,liu brooklyn,3254
2010,75,SMU,31,20,11,2102,67.8,smu,3374
2010,76,UCLA,34,25,9,2305,67.8,ucla,3417
2010,77,Portland St.,33,18,15,2235,67.7,portland st.,3340
2010,78,Kansas,33,17,16,2232,67.6,kansas,3242
2010,79,Memphis,34,20,14,2293,67.4,memphis,3272
2010,80,Marist,34,26,8,2292,67.4,marist,3265
2010,81,Butler,33,23,10,2223,67.4,butler,3139
2010,82,Cal St. Fullerton,32,15,17,2155,67.3,cal st. fullerton,3168
2010,83,UNI,33,17,16,2221,67.3,uni,3320
2010,84,Georgetown,33,26,7,2218,67.2,georgetown,3207
2010,84,Wyoming,33,21,12,2218,67.2,wyoming,3461
2010,86,Drake,30,15,15,2016,67.2,drake,3179
2010,87,Long Beach St.,30,13,17,2015,67.2,long beach st.,3253
2010,88,Liberty,33,27,6,2216,67.2,liberty,3251
2010,88,Chattanooga,33,24,9,2216,67.2,chattanooga,3151
2010,90,Fla. Atlantic,29,14,15,1947,67.1,fla. atlantic,3194
2010,91,UT Arlington,31,15,16,2080,67.1,ut arlington,3426
2010,92,Michigan St.,33,23,10,2214,67.1,michigan st.,3277
2010,93,Ball St.,31,14,17,2079,67.1,ball st.,3123
2010,94,Colorado,30,13,17,2009,67,colorado,3160
2010,95,Appalachian St.,35,23,12,2336,66.7,appalachian st.,3111
2010,96,Louisville,32,14,18,2134,66.7,louisville,3257
2010,97,Vermont,34,27,7,2265,66.6,vermont,3436
2010,98,Cleveland St.,33,19,14,2198,66.6,cleveland st.,3156
2010,99,High Point,31,17,14,2060,66.5,high point,3219
2010,100,Eastern Wash.,31,19,12,2059,66.4,eastern wash.,3186
2010,101,Robert Morris,32,23,9,2124,66.4,robert morris,3352
2010,102,Penn St.,31,17,14,2054,66.3,penn st.,3336
2010,103,Davidson,29,14,15,1921,66.2,davidson,3172
2010,104,Tennessee Tech,30,14,16,1986,66.2,tennessee tech,3399
2010,105,California,37,24,13,2447,66.1,california,3143
2010,106,Little Rock,34,27,7,2246,66.1,little rock,3114
2010,107,Indiana,30,14,16,1980,66,indiana,3231
2010,108,Michigan,35,21,14,2308,65.9,michigan,3276
2010,109,Miami (OH),31,9,22,2044,65.9,miami (oh),3275
2010,110,Charleston So.,31,17,14,2042,65.9,charleston so.,3149
2010,111,Georgia Tech,33,23,10,2172,65.8,georgia tech,3210
2010,112,Pepperdine,32,20,12,2106,65.8,pepperdine,3337
2010,113,Arkansas St.,31,13,18,2038,65.7,arkansas st.,3117
2010,114,Columbia,28,18,10,1839,65.7,columbia,3162
2010,115,Austin Peay,33,15,18,2160,65.5,austin peay,3122
2010,116,UC Davis,32,21,11,2094,65.4,uc davis,3413
2010,117,Arizona,31,14,17,2028,65.4,arizona,3112
2010,118,San Diego St.,34,23,11,2223,65.4,san diego st.,3361
2010,119,Northern Ill.,29,10,19,1896,65.4,northern ill.,3296
2010,120,Iowa St.,33,25,8,2157,65.4,iowa st.,3235
2010,121,Fort Wayne,30,13,17,1960,65.3,iupu-fort wayne,3236
2010,121,Loyola Marymount,30,13,17,1960,65.3,loyola marymount,3258
2010,123,North Texas,31,9,22,2025,65.3,north texas,3317
2010,124,Campbell,30,14,16,1959,65.3,campbell,3144
2010,125,UMKC,32,16,16,2088,65.3,umkc,3282
2010,126,Creighton,32,21,11,2085,65.2,creighton,3166
2010,127,Texas Tech,33,18,15,2150,65.2,texas tech,3403
2010,128,Providence,34,19,15,2215,65.1,providence,3344
2010,129,Prairie View,29,15,14,1889,65.1,prairie view,3341
2010,130,Kent St.,31,20,11,2018,65.1,kent st.,3245
2010,131,Lehigh,33,29,4,2148,65.1,lehigh,3250
2010,132,Arkansas,30,12,18,1948,64.9,arkansas,3116
2010,133,St. Bonaventure,33,23,10,2142,64.9,st. bonaventure,3382
2010,134,Texas St.,27,7,20,1752,64.9,texas st.,3402
2010,135,Belmont,30,15,15,1946,64.9,belmont,3125
2010,136,Southern California,31,19,12,2008,64.8,southern california,3425
2010,137,San Diego,29,15,14,1877,64.7,san diego,3360
2010,138,South Carolina,29,14,15,1874,64.6,south carolina,3376
2010,139,Boston U.,31,16,15,2003,64.6,boston u.,3131
2010,139,South Ala.,31,15,16,2003,64.6,south ala.,3375
2010,141,UCF,27,11,16,1743,64.6,ucf,3416
2010,142,NC State,34,20,14,2194,64.5,nc state,3301
2010,143,Elon,31,12,19,2000,64.5,elon,3189
2010,144,BYU,33,23,10,2129,64.5,byu,3140
2010,145,Rice,30,13,17,1930,64.3,rice,3349
2010,146,Montana,29,15,14,1864,64.3,montana,3285
2010,147,UTSA,30,16,14,1927,64.2,utsa,3427
2010,148,Duquesne,32,20,12,2055,64.2,duquesne,3182
2010,149,Indiana St.,31,17,14,1990,64.2,indiana st.,3232
2010,150,Tulsa,28,12,16,1796,64.1,tulsa,3409
2010,151,New Mexico,32,19,13,2051,64.1,new mexico,3307
2010,152,Mercer,30,14,16,1922,64.1,mercer,3273
2010,153,Iona,32,18,14,2050,64.1,iona,3233
2010,154,Alabama,30,12,18,1921,64,alabama,3104
2010,155,Northern Colo.,30,14,16,1911,63.7,northern colo.,3294
2010,156,Old Dominion,33,19,14,2101,63.7,old dominion,3330
2010,157,UC Irvine,30,9,21,1908,63.6,uc irvine,3414
2010,158,Southern Miss.,30,9,21,1906,63.5,southern miss.,3379
2010,159,Morgan St.,30,17,13,1905,63.5,morgan st.,3288
2010,160,Clemson,31,13,18,1967,63.5,clemson,3155
2010,161,North Dakota St.,29,16,13,1839,63.4,north dakota st.,3295
2010,162,UTEP,32,16,16,2029,63.4,utep,3431
2010,163,Troy,29,12,17,1838,63.4,troy,3407
2010,164,Ark.-Pine Bluff,30,8,22,1901,63.4,ark.-pine bluff,3115
2010,165,Saint Joseph's,32,17,15,2025,63.3,saint joseph's,3386
2010,165,Charlotte,32,18,14,2025,63.3,charlotte,3150
2010,167,Samford,34,23,11,2151,63.3,samford,3359
2010,168,Bradley,31,17,14,1960,63.2,bradley,3133
2010,169,Wichita St.,33,18,15,2086,63.2,wichita st.,3455
2010,169,Nevada,33,17,16,2086,63.2,nevada,3305
2010,171,Northeastern,31,13,18,1959,63.2,northeastern,3318
2010,172,Col. of Charleston,33,21,12,2078,63,col. of charleston,3158
2010,173,Arizona St.,32,18,14,2014,62.9,arizona st.,3113
2010,174,McNeese,29,7,22,1824,62.9,mcneese st,3270
2010,175,West Virginia,35,29,6,2201,62.9,west virginia,3452
2010,176,UC Riverside,33,17,16,2074,62.8,uc riverside,3415
2010,177,Minnesota,30,13,17,1885,62.8,minnesota,3278
2010,178,Ill.-Chicago,30,12,18,1884,62.8,ill.-chicago,3227
2010,179,Sacred Heart,30,19,11,1881,62.7,sacred heart,3357
2010,179,Southeastern La.,30,12,18,1881,62.7,southeastern la.,3368
2010,181,Delaware,33,21,12,2069,62.7,delaware,3174
2010,182,Tennessee St.,28,10,18,1755,62.7,tennessee st.,3398
2010,183,Northwestern,33,18,15,2067,62.6,northwestern,3321
2010,184,Buffalo,30,7,23,1879,62.6,buffalo,3138
2010,185,Akron,32,18,14,2004,62.6,akron,3103
2010,186,Denver,31,18,13,1941,62.6,denver,3176
2010,187,Bethune-Cookman,32,17,15,2002,62.6,bethune-cookman,3126
2010,188,Chicago St.,31,12,19,1939,62.5,chicago st.,3152
2010,189,Georgia,34,25,9,2126,62.5,georgia,3208
2010,190,Pacific,29,6,23,1812,62.5,pacific,3334
2010,191,South Fla.,31,15,16,1935,62.4,south fla.,3378
2010,192,Florida,32,15,17,1995,62.3,florida,3196
2010,193,Marquette,33,17,16,2056,62.3,marquette,3266
2010,194,Manhattan,30,15,15,1869,62.3,manhattan,3264
2010,195,Wisconsin,32,21,11,1993,62.3,wisconsin,3458
2010,196,Hartford,32,27,5,1992,62.3,hartford,3216
2010,197,Hofstra,34,20,14,2115,62.2,hofstra,3220
2010,198,South Carolina St.,33,14,19,2052,62.2,south carolina st.,3354
2010,199,Saint Louis,30,11,19,1865,62.2,saint louis,3387
2010,200,Louisiana,31,9,22,1927,62.2,se louisiana,3368
2010,201,Hampton,32,20,12,1989,62.2,hampton,3214
2010,202,Quinnipiac,30,12,18,1864,62.1,quinnipiac,3346
2010,203,UNLV,31,13,18,1925,62.1,unlv,3424
2010,204,Richmond,33,20,13,2049,62.1,richmond,3350
2010,205,Virginia Tech,30,15,15,1862,62.1,virginia tech,3439
2010,206,UAB,32,17,15,1983,62,uab,3412
2010,207,Yale,28,13,15,1735,62,yale,3463
2010,208,Missouri,30,12,18,1857,61.9,missouri,3281
2010,209,Auburn,31,15,16,1917,61.8,auburn,3120
2010,210,Loyola Chicago,30,15,15,1855,61.8,loyola chicago,3260
2010,211,American,32,22,10,1978,61.8,american,3110
2010,212,Washington St.,30,8,22,1851,61.7,washington st.,3450
2010,213,Kansas St.,32,14,18,1971,61.6,kansas st.,3243
2010,214,Illinois,34,19,15,2090,61.5,illinois,3228
2010,215,Binghamton,30,11,19,1844,61.5,binghamton,3127
2010,216,Detroit Mercy,31,17,14,1905,61.5,detroit mercy,3178
2010,217,Alabama A&M,29,16,13,1782,61.4,alabama a&m,3105
2010,218,Temple,34,25,9,2087,61.4,temple,3396
2010,219,Longwood,29,9,20,1779,61.3,longwood,3255
2010,220,Drexel,31,17,14,1901,61.3,drexel,3180
2010,221,Idaho St.,30,15,15,1839,61.3,idaho st.,3226
2010,221,UTRGV,30,13,17,1839,61.3,utrgv,3410
2010,223,Southern Ill.,29,5,24,1777,61.3,southern ill.,3356
2010,224,Loyola Maryland,30,14,16,1833,61.1,loyola maryland,3259
2010,225,Northern Ariz.,29,5,24,1771,61.1,northern ariz.,3319
2010,226,Wake Forest,32,18,14,1949,60.9,wake forest,3448
2010,227,UC Santa Barbara,32,15,17,1947,60.8,uc santa barbara,3364
2010,228,Milwaukee,31,12,19,1885,60.8,milwaukee,3454
2010,229,FIU,30,14,16,1824,60.8,fiu,3198
2010,230,William & Mary,30,12,18,1823,60.8,william & mary,3456
2010,231,Wofford,29,8,21,1759,60.7,wofford,3459
2010,232,Florida A&M,29,18,11,1758,60.6,florida a&m,3197
2010,233,Washington,31,13,18,1879,60.6,washington,3449
2010,234,CSUN,28,4,24,1695,60.5,lsu,3261
2010,235,Hawaii,30,10,20,1815,60.5,hawaii,3218
2010,236,Alcorn,28,8,20,1691,60.4,alcorn,3108
2010,237,Weber St.,29,9,20,1751,60.4,weber st.,3451
2010,238,Colorado St.,30,13,17,1811,60.4,colorado st.,3161
2010,239,Wagner,30,9,21,1810,60.3,wagner,3447
2010,240,UNCW,31,12,19,1870,60.3,unc,3314
2010,241,Idaho,31,11,20,1868,60.3,idaho,3225
2010,242,Marshall,30,14,16,1803,60.1,marshall,3267
2010,243,Central Conn. St.,30,12,18,1793,59.8,central conn. st.,3148
2010,244,Kennesaw St.,30,11,19,1790,59.7,kennesaw st.,3244
2010,245,Purdue,32,15,17,1909,59.7,purdue,3345
2010,246,Ga. Southern,31,19,12,1841,59.4,ga. southern,3204
2010,246,Holy Cross,31,10,21,1841,59.4,holy cross,3221
2010,248,Mississippi Val.,29,9,20,1718,59.2,mississippi val.,3290
2010,249,Texas Southern,31,13,18,1836,59.2,texas southern,3411
2010,250,Massachusetts,30,11,19,1776,59.2,massachusetts,3269
2010,251,Santa Clara,32,5,27,1893,59.2,santa clara,3365
2010,252,Utah Valley,32,10,22,1891,59.1,utah valley,3430
2010,253,UNC Asheville,30,8,22,1770,59,unc asheville,3421
2010,254,Utah,35,23,12,2064,59,utah,3428
2010,255,Jacksonville,30,10,20,1769,59,jacksonville,3239
2010,256,La.-Monroe,29,10,19,1710,59,la.-monroe,3419
2010,257,Utah St.,30,13,17,1768,58.9,utah st.,3429
2010,258,Georgia St.,30,15,15,1766,58.9,georgia st.,3209
2010,259,Niagara,31,13,18,1824,58.8,niagara,3310
2010,260,Western Caro.,30,7,23,1765,58.8,western caro.,3441
2010,261,Southern U.,32,23,9,1882,58.8,southern u.,3380
2010,262,Lipscomb,30,5,25,1763,58.8,lipscomb,3252
2010,263,UMES,28,12,16,1645,58.8,umes,3271
2010,264,UMBC,30,13,17,1760,58.7,umbc,3420
2010,265,Valparaiso,30,9,21,1755,58.5,valparaiso,3434
2010,266,Grambling,28,13,15,1632,58.3,grambling,3212
2010,267,UNCG,30,10,20,1748,58.3,unc,3314
2010,268,Cornell,27,7,20,1570,58.1,cornell,3165
2010,269,Fairfield,34,20,14,1973,58,fairfield,3193
2010,270,Rutgers,34,19,15,1965,57.8,rutgers,3353
2010,271,Navy,31,17,14,1788,57.7,navy,3298
2010,272,Western Mich.,30,9,21,1729,57.6,western mich.,3444
2010,273,New Hampshire,31,9,22,1784,57.5,new hampshire,3306
2010,274,Monmouth,30,16,14,1725,57.5,monmouth,3284
2010,275,Fairleigh Dickinson,29,9,20,1666,57.4,fairleigh dickinson,3192
2010,276,Ohio,30,8,22,1723,57.4,ohio,3325
2010,277,Jacksonville St.,29,9,20,1661,57.3,jacksonville st.,3240
2010,278,NJIT,29,11,18,1657,57.1,njit,3312
2010,279,Stony Brook,30,10,20,1707,56.9,stony brook,3392
2010,280,Howard,30,16,14,1704,56.8,howard,3224
2010,281,Wright St.,30,11,19,1703,56.8,wright st.,3460
2010,281,Coastal Caro.,30,17,13,1703,56.8,coastal caro.,3157
2010,283,Nicholls St.,28,4,24,1586,56.6,nicholls st.,3311
2010,284,San Jose St.,29,6,23,1641,56.6,san jose st.,3363
2010,285,Coppin St.,29,10,19,1637,56.4,coppin st.,3164
2010,286,Albany (NY),30,11,19,1692,56.4,albany (ny),3107
2010,286,Cincinnati,30,12,18,1692,56.4,cincinnati,3153
2010,288,Colgate,29,10,19,1634,56.3,colgate,3159
2010,289,Oregon St.,31,11,20,1746,56.3,oregon st.,3333
2010,290,North Florida,32,12,20,1796,56.1,north florida,3316
2010,291,Evansville,30,4,26,1683,56.1,evansville,3191
2010,292,Towson,31,15,16,1736,56,towson,3406
2010,293,Fordham,30,8,22,1678,55.9,fordham,3200
2010,294,Siena,29,11,18,1622,55.9,siena,3373
2010,295,Norfolk St.,27,4,23,1507,55.8,norfolk st.,3313
2010,296,Furman,31,7,24,1730,55.8,furman,3202
2010,297,Canisius,31,12,19,1721,55.5,canisius,3145
2010,298,Southern Utah,30,7,23,1665,55.5,southern utah,3381
2010,299,Radford,28,6,22,1553,55.5,radford,3347
2010,300,Alabama St.,30,13,17,1662,55.4,alabama st.,3106
2010,301,Eastern Ky.,29,12,17,1606,55.4,eastern ky.,3184
2010,302,Stetson,30,6,24,1651,55,stetson,3391
2010,303,New Orleans,32,12,20,1757,54.9,new orleans,3309
2010,304,George Washington,28,6,22,1535,54.8,george washington,3203
2010,305,Maine,29,8,21,1582,54.6,maine,3263
2010,306,Bucknell,28,7,21,1527,54.5,bucknell,3137
2010,307,Mt. St. Mary's,28,10,18,1522,54.4,mt. st. mary's,3291
2010,308,Saint Peter's,30,11,19,1626,54.2,saint peter's,3389
2010,309,George Mason,30,10,20,1613,53.8,george mason,3206
2010,310,Rhode Island,29,9,20,1552,53.5,rhode island,3348
2010,311,Southeast Mo. St.,28,7,21,1495,53.4,southeast mo. st.,3369
2010,312,Brown,28,8,20,1493,53.3,brown,3135
2010,313,UT Martin,30,11,19,1595,53.2,ut martin,3404
2010,314,Air Force,30,3,27,1590,53,air force,3102
2010,315,San Francisco,32,5,27,1695,53,san francisco,3362
2010,316,Rider,30,4,26,1581,52.7,rider,3351
2010,317,Winthrop,31,13,18,1633,52.7,winthrop,3457
2010,318,Villanova,30,14,16,1573,52.4,villanova,3437
2010,319,Army West Point,29,11,18,1519,52.4,armstrong,3118
2010,320,La Salle,29,7,22,1503,51.8,la salle,3247
2010,321,IUPUI,29,3,26,1498,51.7,iupui,3237
2010,322,Dartmouth,28,11,17,1438,51.4,dartmouth,3171
2010,323,Seton Hall,30,9,21,1535,51.2,seton hall,3371
2010,324,Jackson St.,28,6,22,1415,50.5,jackson st.,3238
2010,325,Western Ill.,31,11,20,1538,49.6,western ill.,3442
2010,326,St. Francis Brooklyn,29,2,27,1411,48.7,st. francis brooklyn,3383
2010,327,Youngstown St.,30,0,30,1457,48.6,youngstown st.,3464
2010,328,Delaware St.,30,6,24,1450,48.3,delaware st.,3175
2010,329,Savannah St.,30,9,21,1440,48,savannah st.,3366
2010,330,Centenary (LA),29,2,27,1385,47.8,centenary (la),3147
2010,331,Lafayette,29,6,23,1376,47.4,lafayette,3248
2010,332,Penn,28,2,26,1292,46.1,penn,3335
2011,1,Gonzaga,36,31,5,3071,85.3,gonzaga,3211
2011,2,Oral Roberts,34,23,11,2870,84.4,oral roberts,3331
2011,3,Central Mich.,31,20,11,2494,80.5,central mich.,3141
2011,4,Miami (FL),33,28,5,2636,79.9,miami (fl),3274
2011,5,Stanford,36,33,3,2856,79.3,stanford,3390
2011,6,Tennessee,37,34,3,2934,79.3,tennessee,3397
2011,7,Baylor,37,34,3,2922,79,baylor,3124
2011,8,Boston College,33,20,13,2571,77.9,boston college,3130
2011,9,North Carolina,37,28,9,2882,77.9,north carolina,3314
2011,10,Texas A&M,38,33,5,2949,77.6,texas a&m,3401
2011,11,Notre Dame,39,31,8,3004,77,notre dame,3323
2011,12,Penn St.,35,25,10,2692,76.9,penn st.,3336
2011,13,UConn,38,36,2,2909,76.6,uconn,3163
2011,14,CSU Bakersfield,34,22,12,2600,76.5,cs bakersfield,3167
2011,15,Oregon,30,13,17,2290,76.3,oregon,3332
2011,16,Texas,33,19,14,2517,76.3,texas,3400
2011,17,NC State,31,14,17,2356,76,nc state,3301
2011,18,Fresno St.,33,25,8,2504,75.9,fresno st.,3201
2011,19,Oklahoma,35,23,12,2653,75.8,oklahoma,3328
2011,20,Hofstra,31,19,12,2332,75.2,hofstra,3220
2011,21,Houston,32,26,6,2384,74.5,houston,3222
2011,22,Xavier,32,29,3,2375,74.2,xavier,3462
2011,23,Dayton,33,21,12,2448,74.2,dayton,3173
2011,24,Ohio St.,34,24,10,2518,74.1,ohio st.,3326
2011,25,Green Bay,36,34,2,2666,74.1,green bay,3453
2011,26,Fort Wayne,31,20,11,2294,74,iupu-fort wayne,3236
2011,27,Lamar University,33,25,8,2437,73.8,american university,3110
2011,28,Arizona,33,21,12,2433,73.7,arizona,3112
2011,29,DePaul,36,29,7,2650,73.6,depaul,3177
2011,30,Florida St.,32,24,8,2352,73.5,florida st.,3199
2011,31,Appalachian St.,32,25,7,2338,73.1,appalachian st.,3111
2011,32,Louisiana Tech,32,24,8,2335,73,louisiana tech,3256
2011,33,Tulane,34,23,11,2480,72.9,tulane,3408
2011,33,Chicago St.,34,24,10,2480,72.9,chicago st.,3152
2011,35,UT Martin,32,21,11,2316,72.4,ut martin,3404
2011,36,ETSU,31,19,12,2235,72.1,etsu,3190
2011,37,Bowling Green,33,28,5,2371,71.8,bowling green,3132
2011,38,Maryland,32,24,8,2293,71.7,maryland,3268
2011,39,Harvard,28,18,10,2000,71.4,harvard,3217
2011,40,Vanderbilt,32,20,12,2281,71.3,vanderbilt,3435
2011,41,Louisville,35,22,13,2492,71.2,louisville,3257
2011,42,Iowa,31,22,9,2201,71,iowa,3234
2011,43,Kentucky,34,25,9,2412,70.9,kentucky,3246
2011,44,Central Ark.,33,21,12,2336,70.8,central ark.,3146
2011,45,Morehead St.,31,21,10,2191,70.7,morehead st.,3287
2011,46,Duke,36,32,4,2538,70.5,duke,3181
2011,47,James Madison,34,26,8,2395,70.4,james madison,3241
2011,48,East Carolina,31,16,15,2180,70.3,east carolina,3187
2011,49,Sacramento St.,29,4,25,2036,70.2,sacramento st.,3170
2011,50,Syracuse,35,25,10,2451,70,syracuse,3393
2011,51,Kansas,34,21,13,2380,70,kansas,3242
2011,51,Middle Tenn.,31,23,8,2170,70,middle tenn.,3292
2011,53,Portland,31,16,15,2166,69.9,portland,3339
2011,54,Charlotte,37,27,10,2584,69.8,charlotte,3150
2011,55,SFA,30,12,18,2095,69.8,utsa,3427
2011,56,Montana St.,31,17,14,2163,69.8,montana st.,3286
2011,57,UNI,33,27,6,2300,69.7,uni,3320
2011,58,Eastern Ill.,31,18,13,2158,69.6,eastern ill.,3183
2011,59,UTEP,30,16,14,2088,69.6,utep,3431
2011,60,Miami (OH),30,11,19,2087,69.6,miami (oh),3275
2011,61,Pepperdine,30,18,12,2084,69.5,pepperdine,3337
2011,62,Missouri St.,35,24,11,2431,69.5,missouri st.,3283
2011,63,Duquesne,33,24,9,2291,69.4,duquesne,3182
2011,64,Utah St.,33,18,15,2287,69.3,utah st.,3429
2011,65,Sam Houston St.,31,17,14,2148,69.3,sam houston st.,3358
2011,66,BYU,34,25,9,2355,69.3,byu,3140
2011,67,Southern California,37,24,13,2561,69.2,southern california,3425
2011,68,Princeton,29,24,5,2006,69.2,princeton,3343
2011,69,McNeese,33,26,7,2280,69.1,mcneese st,3270
2011,70,N.C. A&T,29,15,14,2000,69,n.c. a&t,3299
2011,71,High Point,31,16,15,2136,68.9,high point,3219
2011,72,UC Davis,33,24,9,2261,68.5,uc davis,3413
2011,73,UCF,33,22,11,2255,68.3,ucf,3416
2011,74,Cal Poly,31,18,13,2118,68.3,cal poly,3142
2011,75,Saint Francis (PA),34,22,12,2318,68.2,saint francis (pa),3384
2011,76,Elon,33,20,13,2247,68.1,elon,3189
2011,77,Wright St.,33,20,13,2245,68,wright st.,3460
2011,78,Southern Utah,30,16,14,2039,68,southern utah,3381
2011,79,UNCW,33,24,9,2242,67.9,unc,3314
2011,80,Illinois St.,35,24,11,2377,67.9,illinois st.,3229
2011,81,Temple,33,24,9,2241,67.9,temple,3396
2011,82,Portland St.,32,20,12,2173,67.9,portland st.,3340
2011,83,VCU,31,19,12,2100,67.7,vcu,3433
2011,84,TCU,33,22,11,2235,67.7,tcu,3395
2011,85,UNC Asheville,30,12,18,2031,67.7,unc asheville,3421
2011,86,Eastern Mich.,37,24,13,2500,67.6,eastern mich.,3185
2011,87,Oklahoma St.,32,17,15,2162,67.6,oklahoma st.,3329
2011,88,Nevada,33,22,11,2228,67.5,nevada,3305
2011,89,Saint Mary's (CA),32,19,13,2160,67.5,saint mary's (ca),3388
2011,90,UTRGV,31,12,19,2091,67.5,utrgv,3410
2011,91,Michigan St.,33,27,6,2220,67.3,michigan st.,3277
2011,92,Eastern Wash.,31,13,18,2085,67.3,eastern wash.,3186
2011,93,Tennessee Tech,31,23,8,2084,67.2,tennessee tech,3399
2011,94,Boise St.,31,12,19,2081,67.1,boise st.,3129
2011,95,South Dakota St.,33,19,14,2215,67.1,south dakota st.,3355
2011,96,Marist,34,31,3,2281,67.1,marist,3265
2011,97,UC Irvine,30,15,15,2011,67,uc irvine,3414
2011,98,Butler,34,20,14,2278,67,butler,3139
2011,99,Kent St.,30,20,10,2005,66.8,kent st.,3245
2011,100,Chattanooga,31,17,14,2071,66.8,chattanooga,3151
2011,101,Virginia,35,19,16,2338,66.8,virginia,3438
2011,102,SMU,30,14,16,2002,66.7,smu,3374
2011,102,Northwestern St.,30,14,16,2002,66.7,northwestern st.,3322
2011,104,Florida,35,20,15,2331,66.6,florida,3196
2011,105,Northwestern,33,19,14,2197,66.6,northwestern,3321
2011,106,Toledo,37,29,8,2463,66.6,toledo,3405
2011,107,Richmond,30,18,12,1996,66.5,richmond,3350
2011,108,Wyoming,33,24,9,2195,66.5,wyoming,3461
2011,109,Wake Forest,32,15,17,2127,66.5,wake forest,3448
2011,109,Buffalo,32,16,16,2127,66.5,buffalo,3138
2011,111,San Diego,31,17,14,2059,66.4,san diego,3360
2011,112,Marquette,33,24,9,2189,66.3,marquette,3266
2011,113,Pittsburgh,31,14,17,2055,66.3,pittsburgh,3338
2011,114,Akron,30,14,16,1988,66.3,akron,3103
2011,114,Idaho St.,30,18,12,1988,66.3,idaho st.,3226
2011,116,West Virginia,34,24,10,2251,66.2,west virginia,3452
2011,117,Charleston So.,30,14,16,1984,66.1,charleston so.,3149
2011,118,Georgia Tech,35,24,11,2314,66.1,georgia tech,3210
2011,119,Alabama,33,18,15,2179,66,alabama,3104
2011,120,Campbell,30,13,17,1979,66,campbell,3144
2011,121,North Dakota St.,29,13,16,1912,65.9,north dakota st.,3295
2011,122,Indiana St.,32,16,16,2105,65.8,indiana st.,3232
2011,123,Milwaukee,30,12,18,1973,65.8,milwaukee,3454
2011,124,Cleveland St.,33,21,12,2167,65.7,cleveland st.,3156
2011,125,Memphis,34,21,13,2232,65.6,memphis,3272
2011,126,UCLA,33,28,5,2166,65.6,ucla,3417
2011,127,New Mexico St.,32,14,18,2095,65.5,new mexico st.,3308
2011,128,Hampton,32,25,7,2094,65.4,hampton,3214
2011,129,Texas Tech,33,22,11,2159,65.4,texas tech,3403
2011,130,Northern Colo.,31,17,14,2028,65.4,northern colo.,3294
2011,131,Stetson,33,20,13,2154,65.3,stetson,3391
2011,132,Cal St. Fullerton,30,9,21,1958,65.3,cal st. fullerton,3168
2011,133,Oakland,32,20,12,2087,65.2,oakland,3324
2011,134,Iowa St.,33,22,11,2152,65.2,iowa st.,3235
2011,135,Drake,30,15,15,1949,65,drake,3179
2011,136,Michigan,30,17,13,1948,64.9,michigan,3276
2011,137,Denver,31,19,12,2012,64.9,denver,3176
2011,138,Rice,32,18,14,2074,64.8,rice,3349
2011,139,Bradley,31,15,16,2009,64.8,bradley,3133
2011,140,UMKC,30,14,16,1942,64.7,umkc,3282
2011,141,Texas St.,29,9,20,1876,64.7,texas st.,3402
2011,142,Arkansas,34,22,12,2196,64.6,arkansas,3116
2011,143,Florida A&M,30,15,15,1937,64.6,florida a&m,3197
2011,144,Lehigh,32,21,11,2066,64.6,lehigh,3250
2011,145,Purdue,33,21,12,2125,64.4,purdue,3345
2011,146,Old Dominion,31,20,11,1993,64.3,old dominion,3330
2011,147,North Texas,30,5,25,1927,64.2,north texas,3317
2011,148,UC Santa Barbara,31,19,12,1989,64.2,uc santa barbara,3364
2011,149,UC Riverside,32,19,13,2052,64.1,uc riverside,3415
2011,150,Georgetown,35,24,11,2240,64,georgetown,3207
2011,151,Jacksonville,32,15,17,2047,64,jacksonville,3239
2011,152,Minnesota,30,12,18,1919,64,minnesota,3278
2011,153,Nebraska,31,13,18,1982,63.9,nebraska,3304
2011,154,Ill.-Chicago,30,14,16,1918,63.9,ill.-chicago,3227
2011,155,Western Ky.,32,15,17,2045,63.9,western ky.,3443
2011,156,Gardner-Webb,34,23,11,2172,63.9,gardner-webb,3205
2011,157,Northern Ariz.,29,11,18,1852,63.9,northern ariz.,3319
2011,158,Robert Morris,30,16,14,1914,63.8,robert morris,3352
2011,159,UTSA,31,16,15,1975,63.7,utsa,3427
2011,160,Quinnipiac,30,14,16,1911,63.7,quinnipiac,3346
2011,161,Georgia,34,23,11,2163,63.6,georgia,3208
2011,162,Samford,33,25,8,2098,63.6,samford,3359
2011,163,Indiana,29,9,20,1838,63.4,indiana,3231
2011,164,Wichita St.,32,17,15,2027,63.3,wichita st.,3455
2011,165,Southeastern La.,29,13,16,1830,63.1,southeastern la.,3368
2011,166,La.-Monroe,31,16,15,1956,63.1,la.-monroe,3419
2011,167,Massachusetts,30,7,23,1890,63,massachusetts,3269
2011,168,Idaho,31,15,16,1952,63,idaho,3225
2011,168,Washington St.,31,8,23,1952,63,washington st.,3450
2011,170,Louisiana,30,11,19,1889,63,se louisiana,3368
2011,171,A&M-Corpus Christi,29,2,27,1826,63,a&m-corpus chris,3394
2011,172,Illinois,32,9,23,2014,62.9,illinois,3228
2011,173,Utah Valley,29,8,21,1825,62.9,utah valley,3430
2011,174,Loyola Chicago,31,12,19,1949,62.9,loyola chicago,3260
2011,175,Murray St.,30,9,21,1886,62.9,murray st.,3293
2011,176,California,34,18,16,2137,62.9,california,3143
2011,177,Boston U.,31,17,14,1947,62.8,boston u.,3131
2011,178,William & Mary,29,3,26,1821,62.8,william & mary,3456
2011,179,South Ala.,30,17,13,1883,62.8,south ala.,3375
2011,180,Ball St.,30,9,21,1879,62.6,ball st.,3123
2011,181,St. John's (NY),33,22,11,2066,62.6,st. john's (ny),3385
2011,182,Lipscomb,30,9,21,1878,62.6,lipscomb,3252
2011,183,Wagner,29,12,17,1812,62.5,wagner,3447
2011,184,Pacific,31,9,22,1936,62.5,pacific,3334
2011,185,Nicholls St.,29,8,21,1807,62.3,nicholls st.,3311
2011,186,Creighton,31,18,13,1930,62.3,creighton,3166
2011,187,Furman,30,14,16,1866,62.2,furman,3202
2011,188,Colorado,34,18,16,2114,62.2,colorado,3160
2011,189,LIU Brooklyn,30,19,11,1860,62,liu brooklyn,3254
2011,190,Eastern Ky.,27,6,21,1673,62,eastern ky.,3184
2011,191,LSU,32,19,13,1981,61.9,lsu,3261
2011,192,Austin Peay,33,15,18,2041,61.8,austin peay,3122
2011,193,Tulsa,25,5,20,1545,61.8,tulsa,3409
2011,194,Long Beach St.,31,8,23,1915,61.8,long beach st.,3253
2011,195,Coppin St.,30,13,17,1853,61.8,coppin st.,3164
2011,196,Davidson,31,14,17,1913,61.7,davidson,3172
2011,197,Yale,29,14,15,1789,61.7,yale,3463
2011,198,Santa Clara,30,11,19,1849,61.6,santa clara,3365
2011,199,Montana,33,18,15,2031,61.5,montana,3285
2011,200,Rutgers,33,20,13,2027,61.4,rutgers,3353
2011,201,Delaware,34,20,14,2086,61.4,delaware,3174
2011,202,Saint Joseph's,32,20,12,1963,61.3,saint joseph's,3386
2011,203,FIU,32,16,16,1962,61.3,fiu,3198
2011,204,American,31,22,9,1897,61.2,american,3110
2011,205,UNLV,31,11,20,1896,61.2,unlv,3424
2011,206,Auburn,32,16,16,1954,61.1,auburn,3120
2011,207,La Salle,30,10,20,1830,61,la salle,3247
2011,207,UNCG,29,13,16,1769,61,unc,3314
2011,209,Drexel,32,19,13,1951,61,drexel,3180
2011,210,Kansas St.,32,21,11,1950,60.9,kansas st.,3243
2011,211,Southern Miss.,30,10,20,1826,60.9,southern miss.,3379
2011,212,Virginia Tech,30,11,19,1824,60.8,virginia tech,3439
2011,213,Loyola Marymount,29,11,18,1762,60.8,loyola marymount,3258
2011,214,Air Force,31,9,22,1883,60.7,air force,3102
2011,214,Detroit Mercy,31,13,18,1883,60.7,detroit mercy,3178
2011,214,New Mexico,31,13,18,1883,60.7,new mexico,3307
2011,217,Wofford,30,8,22,1822,60.7,wofford,3459
2011,218,Liberty,33,22,11,2001,60.6,liberty,3251
2011,219,Jacksonville St.,31,10,21,1876,60.5,jacksonville st.,3240
2011,220,Holy Cross,30,10,20,1815,60.5,holy cross,3221
2011,221,Hawaii,30,11,19,1814,60.5,hawaii,3218
2011,222,Stony Brook,30,7,23,1813,60.4,stony brook,3392
2011,223,Monmouth,33,23,10,1994,60.4,monmouth,3284
2011,224,Colorado St.,30,14,16,1812,60.4,colorado st.,3161
2011,224,Radford,30,14,16,1812,60.4,radford,3347
2011,226,South Fla.,31,12,19,1872,60.4,south fla.,3378
2011,227,Tennessee St.,30,9,21,1810,60.3,tennessee st.,3398
2011,228,Arizona St.,31,20,11,1870,60.3,arizona st.,3113
2011,229,Western Mich.,30,9,21,1807,60.2,western mich.,3444
2011,230,Sacred Heart,31,18,13,1867,60.2,sacred heart,3357
2011,231,St. Bonaventure,33,21,12,1983,60.1,st. bonaventure,3382
2011,232,Longwood,30,7,23,1801,60,longwood,3255
2011,233,San Francisco,29,4,25,1739,60,san francisco,3362
2011,234,Weber St.,28,7,21,1679,60,weber st.,3451
2011,235,Clemson,30,10,20,1796,59.9,clemson,3155
2011,236,Alabama A&M,29,15,14,1736,59.9,alabama a&m,3105
2011,237,Wisconsin,31,16,15,1854,59.8,wisconsin,3458
2011,238,George Mason,30,13,17,1791,59.7,george mason,3206
2011,239,Mississippi Val.,31,14,17,1849,59.6,mississippi val.,3290
2011,240,Kennesaw St.,30,9,21,1786,59.5,kennesaw st.,3244
2011,241,Missouri,31,13,18,1842,59.4,missouri,3281
2011,242,Fla. Atlantic,28,7,21,1663,59.4,fla. atlantic,3194
2011,243,Grambling,31,15,16,1841,59.4,grambling,3212
2011,244,Colgate,29,7,22,1721,59.3,colgate,3159
2011,245,Alcorn,28,13,15,1661,59.3,alcorn,3108
2011,246,San Diego St.,29,12,17,1720,59.3,san diego st.,3361
2011,247,Arkansas St.,32,18,14,1893,59.2,arkansas st.,3117
2011,248,UAB,35,20,15,2069,59.1,uab,3412
2011,249,UT Arlington,28,8,20,1654,59.1,ut arlington,3426
2011,250,Mercer,29,2,27,1708,58.9,mercer,3273
2011,251,Loyola Maryland,34,21,13,2000,58.8,loyola maryland,3259
2011,252,New Hampshire,29,9,20,1705,58.8,new hampshire,3306
2011,253,South Carolina,33,18,15,1937,58.7,south carolina,3376
2011,254,Norfolk St.,28,9,19,1640,58.6,norfolk st.,3313
2011,255,Iona,31,11,20,1815,58.5,iona,3233
2011,256,Youngstown St.,30,6,24,1754,58.5,youngstown st.,3464
2011,257,Ole Miss,29,10,19,1695,58.4,ole miss,3279
2011,258,Ga. Southern,30,12,18,1753,58.4,ga. southern,3204
2011,258,Northeastern,30,8,22,1753,58.4,northeastern,3318
2011,260,Little Rock,31,23,8,1811,58.4,little rock,3114
2011,261,Valparaiso,31,7,24,1809,58.4,valparaiso,3434
2011,262,Utah,35,18,17,2039,58.3,utah,3428
2011,263,Mississippi St.,30,13,17,1746,58.2,mississippi st.,3280
2011,264,Belmont,31,11,20,1795,57.9,belmont,3125
2011,265,Mt. St. Mary's,29,8,21,1676,57.8,mt. st. mary's,3291
2011,266,Northern Ill.,30,13,17,1733,57.8,northern ill.,3296
2011,267,Navy,32,20,12,1844,57.6,navy,3298
2011,267,Southern U.,32,20,12,1844,57.6,southern u.,3380
2011,269,Georgia St.,31,12,19,1786,57.6,georgia st.,3209
2011,270,Western Ill.,29,8,21,1662,57.3,western ill.,3442
2011,271,CSUN,30,4,26,1719,57.3,lsu,3261
2011,272,Evansville,30,8,22,1714,57.1,evansville,3191
2011,273,Fairleigh Dickinson,30,14,16,1710,57,fairleigh dickinson,3192
2011,274,Central Conn. St.,30,19,11,1708,56.9,central conn. st.,3148
2011,275,Savannah St.,26,15,11,1480,56.9,savannah st.,3366
2011,276,Manhattan,34,24,10,1934,56.9,manhattan,3264
2011,277,Binghamton,31,19,12,1761,56.8,binghamton,3127
2011,278,UMBC,32,20,12,1817,56.8,umbc,3420
2011,279,Hartford,33,17,16,1872,56.7,hartford,3216
2011,280,North Florida,30,13,17,1699,56.6,north florida,3316
2011,281,Providence,29,13,16,1641,56.6,providence,3344
2011,282,Fordham,31,12,19,1754,56.6,fordham,3200
2011,283,Ohio,31,9,22,1749,56.4,ohio,3325
2011,284,Bethune-Cookman,29,13,16,1633,56.3,bethune-cookman,3126
2011,285,Washington,28,11,17,1574,56.2,washington,3449
2011,286,Saint Louis,29,7,22,1630,56.2,saint louis,3387
2011,287,Towson,30,9,21,1684,56.1,towson,3406
2011,288,Troy,30,5,25,1679,56,troy,3407
2011,289,Rhode Island,28,7,21,1566,55.9,rhode island,3348
2011,290,Centenary (LA),25,1,24,1397,55.9,centenary (la),3147
2011,291,South Carolina St.,29,12,17,1616,55.7,south carolina st.,3354
2011,292,Prairie View,33,21,12,1833,55.5,prairie view,3341
2011,293,George Washington,29,8,21,1610,55.5,george washington,3203
2011,294,Columbia,28,7,21,1553,55.5,columbia,3162
2011,295,Morgan St.,32,17,15,1771,55.3,morgan st.,3288
2011,296,Fairfield,30,17,13,1660,55.3,fairfield,3193
2011,297,Albany (NY),30,16,14,1654,55.1,albany (ny),3107
2011,298,IUPUI,28,4,24,1538,54.9,iupui,3237
2011,299,Western Caro.,31,9,22,1699,54.8,western caro.,3441
2011,300,Lafayette,30,11,19,1642,54.7,lafayette,3248
2011,301,Brown,28,10,18,1531,54.7,brown,3135
2011,302,UMES,31,12,19,1694,54.6,umes,3271
2011,303,Maine,29,4,25,1583,54.6,maine,3263
2011,304,Seton Hall,30,8,22,1634,54.5,seton hall,3371
2011,305,Texas Southern,29,5,24,1576,54.3,texas southern,3411
2011,306,Bucknell,28,11,17,1517,54.2,bucknell,3137
2011,307,Alabama St.,30,8,22,1621,54,alabama st.,3106
2011,308,Oregon St.,30,9,21,1618,53.9,oregon st.,3333
2011,309,Jackson St.,28,9,19,1510,53.9,jackson st.,3238
2011,310,Dartmouth,28,7,21,1509,53.9,dartmouth,3171
2011,311,Penn,28,11,17,1504,53.7,penn,3335
2011,312,Howard,34,16,18,1826,53.7,howard,3224
2011,313,Canisius,31,11,20,1660,53.5,canisius,3145
2011,314,NJIT,28,7,21,1498,53.5,njit,3312
2011,315,Coastal Caro.,29,10,19,1545,53.3,coastal caro.,3157
2011,316,Marshall,30,9,21,1597,53.2,marshall,3267
2011,317,Army West Point,29,13,16,1541,53.1,armstrong,3118
2011,318,Delaware St.,29,9,20,1540,53.1,delaware st.,3175
2011,319,Ark.-Pine Bluff,29,1,28,1539,53.1,ark.-pine bluff,3115
2011,320,Saint Peter's,31,6,25,1638,52.8,saint peter's,3389
2011,321,Cincinnati,29,9,20,1522,52.5,cincinnati,3153
2011,322,Rider,30,5,25,1568,52.3,rider,3351
2011,323,Siena,30,14,16,1567,52.2,siena,3373
2011,324,Col. of Charleston,30,10,20,1566,52.2,col. of charleston,3158
2011,325,Cornell,28,6,22,1444,51.6,cornell,3165
2011,326,Winthrop,31,13,18,1598,51.5,winthrop,3457
2011,327,Southeast Mo. St.,29,8,21,1492,51.4,southeast mo. st.,3369
2011,328,Villanova,31,12,19,1585,51.1,villanova,3437
2011,329,Southern Ill.,30,2,28,1527,50.9,southern ill.,3356
2011,330,St. Francis Brooklyn,29,2,27,1412,48.7,st. francis brooklyn,3383
2011,331,Niagara,30,1,29,1449,48.3,niagara,3310
2011,332,Vermont,30,5,25,1434,47.8,vermont,3436
2011,333,San Jose St.,29,2,27,1383,47.7,san jose st.,3363
2012,1,UT Martin,32,23,9,2563,80.1,ut martin,3404
2012,2,Notre Dame,39,35,4,3076,78.9,notre dame,3323
2012,3,Baylor,40,40,0,3136,78.4,baylor,3124
2012,4,Maryland,36,31,5,2781,77.3,maryland,3268
2012,5,UConn,38,33,5,2903,76.4,uconn,3163
2012,6,Stanford,37,35,2,2811,76,stanford,3390
2012,7,Miami (FL),32,26,6,2430,75.9,miami (fl),3274
2012,8,Penn St.,33,26,7,2498,75.7,penn st.,3336
2012,9,Duke,33,27,6,2480,75.2,duke,3181
2012,10,Gonzaga,34,28,6,2555,75.1,gonzaga,3211
2012,11,Fresno St.,34,28,6,2547,74.9,fresno st.,3201
2012,12,Hofstra,31,19,12,2321,74.9,hofstra,3220
2012,13,Ohio St.,32,25,7,2393,74.8,ohio st.,3326
2012,14,FGCU,32,29,3,2382,74.4,fgcu,3195
2012,15,Green Bay,33,31,2,2452,74.3,green bay,3453
2012,16,Tennessee,36,27,9,2664,74,tennessee,3397
2012,17,Kentucky,35,28,7,2589,74,kentucky,3246
2012,18,Akron,32,14,18,2361,73.8,akron,3103
2012,19,Missouri St.,33,24,9,2401,72.8,missouri st.,3283
2012,20,Oral Roberts,31,20,11,2251,72.6,oral roberts,3331
2012,21,Utah St.,31,21,10,2243,72.4,utah st.,3429
2012,22,Princeton,29,24,5,2089,72,princeton,3343
2012,23,DePaul,34,23,11,2449,72,depaul,3177
2012,23,UMKC,34,22,12,2449,72,umkc,3282
2012,25,Vanderbilt,33,23,10,2369,71.8,vanderbilt,3435
2012,26,Cal Poly,32,17,15,2296,71.8,cal poly,3142
2012,27,Eastern Ill.,31,22,9,2224,71.7,eastern ill.,3183
2012,28,Sacramento St.,31,13,18,2222,71.7,sacramento st.,3170
2012,29,Delaware,33,31,2,2363,71.6,delaware,3174
2012,30,Nebraska,33,24,9,2356,71.4,nebraska,3304
2012,31,Iowa,31,19,12,2212,71.4,iowa,3234
2012,32,Central Mich.,36,20,16,2560,71.1,central mich.,3141
2012,33,BYU,33,26,7,2345,71.1,byu,3140
2012,34,Oregon,31,15,16,2201,71,oregon,3332
2012,35,Georgia Tech,35,26,9,2483,70.9,georgia tech,3210
2012,36,Oklahoma,34,21,13,2408,70.8,oklahoma,3328
2012,37,Charleston So.,32,17,15,2259,70.6,charleston so.,3149
2012,38,Liberty,33,24,9,2323,70.4,liberty,3251
2012,39,Florida A&M,30,22,8,2111,70.4,florida a&m,3197
2012,40,CSU Bakersfield,29,7,22,2040,70.3,cs bakersfield,3167
2012,41,Dayton,30,23,7,2104,70.1,dayton,3173
2012,42,California,35,25,10,2449,70,california,3143
2012,43,Winthrop,31,18,13,2159,69.6,winthrop,3457
2012,44,High Point,33,20,13,2294,69.5,high point,3219
2012,45,Portland St.,29,15,14,2014,69.4,portland st.,3340
2012,46,North Carolina,31,20,11,2151,69.4,north carolina,3314
2012,47,Pacific,32,18,14,2215,69.2,pacific,3334
2012,48,Wake Forest,34,20,14,2353,69.2,wake forest,3448
2012,49,Wright St.,34,21,13,2352,69.2,wright st.,3460
2012,50,Murray St.,31,13,18,2144,69.2,murray st.,3293
2012,51,N.C. A&T,31,15,16,2140,69,n.c. a&t,3299
2012,52,Louisville,33,23,10,2271,68.8,louisville,3257
2012,53,Eastern Mich.,32,23,9,2199,68.7,eastern mich.,3185
2012,54,Montana St.,30,19,11,2061,68.7,montana st.,3286
2012,55,Memphis,33,25,8,2266,68.7,memphis,3272
2012,56,Kansas,34,21,13,2334,68.6,kansas,3242
2012,57,William & Mary,30,10,20,2058,68.6,william & mary,3456
2012,58,Syracuse,37,22,15,2537,68.6,syracuse,3393
2012,59,Georgia,31,22,9,2122,68.5,georgia,3208
2012,60,Bradley,34,18,16,2322,68.3,bradley,3133
2012,61,Charlotte,30,16,14,2045,68.2,charlotte,3150
2012,62,South Dakota St.,33,24,9,2249,68.2,south dakota st.,3355
2012,63,Miami (OH),31,21,10,2112,68.1,miami (oh),3275
2012,64,Tennessee St.,29,9,20,1973,68,tennessee st.,3398
2012,65,Texas St.,31,17,14,2107,68,texas st.,3402
2012,66,Quinnipiac,32,22,10,2173,67.9,quinnipiac,3346
2012,66,Robert Morris,32,18,14,2173,67.9,robert morris,3352
2012,68,NC State,35,19,16,2374,67.8,nc state,3301
2012,68,Texas A&M,35,24,11,2374,67.8,texas a&m,3401
2012,70,Richmond,32,23,9,2166,67.7,richmond,3350
2012,71,Illinois St.,32,19,13,2165,67.7,illinois st.,3229
2012,72,Boise St.,31,15,16,2096,67.6,boise st.,3129
2012,73,Duquesne,32,20,12,2162,67.6,duquesne,3182
2012,74,UTEP,33,29,4,2229,67.5,utep,3431
2012,75,Florida,33,20,13,2228,67.5,florida,3196
2012,76,Nevada,30,7,23,2025,67.5,nevada,3305
2012,77,Texas,32,18,14,2155,67.3,texas,3400
2012,78,Eastern Wash.,30,16,14,2020,67.3,eastern wash.,3186
2012,79,Minnesota,36,19,17,2423,67.3,minnesota,3278
2012,80,Florida St.,31,14,17,2086,67.3,florida st.,3199
2012,81,Michigan St.,32,20,12,2145,67,michigan st.,3277
2012,82,Texas Tech,35,21,14,2346,67,texas tech,3403
2012,83,Stetson,34,23,11,2272,66.8,stetson,3391
2012,84,Appalachian St.,34,27,7,2266,66.6,appalachian st.,3111
2012,85,Bowling Green,31,24,7,2065,66.6,bowling green,3132
2012,86,Louisiana Tech,32,17,15,2131,66.6,louisiana tech,3256
2012,87,Austin Peay,31,9,22,2064,66.6,austin peay,3122
2012,88,Nicholls St.,31,16,15,2063,66.5,nicholls st.,3311
2012,89,Northwestern St.,29,6,23,1926,66.4,northwestern st.,3322
2012,90,Northern Ariz.,29,9,20,1924,66.3,northern ariz.,3319
2012,91,Arizona,32,15,17,2123,66.3,arizona,3112
2012,92,Middle Tenn.,33,26,7,2186,66.2,middle tenn.,3292
2012,93,Oklahoma St.,34,22,12,2252,66.2,oklahoma st.,3329
2012,94,Central Ark.,31,24,7,2053,66.2,central ark.,3146
2012,94,Radford,31,16,15,2053,66.2,radford,3347
2012,96,Santa Clara,30,12,18,1985,66.2,santa clara,3365
2012,97,Western Ill.,31,12,19,2050,66.1,western ill.,3442
2012,98,ETSU,30,8,22,1983,66.1,etsu,3190
2012,99,McNeese,34,26,8,2244,66,mcneese st,3270
2012,100,San Diego,35,26,9,2304,65.8,san diego,3360
2012,101,VCU,34,19,15,2236,65.8,vcu,3433
2012,101,Purdue,34,25,9,2236,65.8,purdue,3345
2012,103,Loyola Chicago,30,13,17,1972,65.7,loyola chicago,3260
2012,104,Temple,33,23,10,2168,65.7,temple,3396
2012,105,Saint Mary's (CA),33,22,11,2165,65.6,saint mary's (ca),3388
2012,106,Yale,28,16,12,1836,65.6,yale,3463
2012,107,Tennessee Tech,34,17,17,2228,65.5,tennessee tech,3399
2012,108,UNI,34,19,15,2225,65.4,uni,3320
2012,109,San Diego St.,32,25,7,2089,65.3,san diego st.,3361
2012,110,Saint Francis (PA),30,14,16,1957,65.2,saint francis (pa),3384
2012,111,Saint Joseph's,33,22,11,2152,65.2,saint joseph's,3386
2012,112,Hampton,31,26,5,2021,65.2,hampton,3214
2012,113,Harvard,30,18,12,1955,65.2,harvard,3217
2012,114,Morehead St.,29,10,19,1889,65.1,morehead st.,3287
2012,115,Marist,34,26,8,2211,65,marist,3265
2012,116,Oregon St.,33,20,13,2141,64.9,oregon st.,3333
2012,117,Campbell,30,18,12,1946,64.9,campbell,3144
2012,118,Detroit Mercy,34,20,14,2199,64.7,detroit mercy,3178
2012,119,Youngstown St.,30,10,20,1938,64.6,youngstown st.,3464
2012,120,UC Irvine,30,13,17,1937,64.6,uc irvine,3414
2012,121,Mississippi Val.,32,18,14,2065,64.5,mississippi val.,3290
2012,122,SFA,33,23,10,2127,64.5,utsa,3427
2012,123,Eastern Ky.,29,13,16,1869,64.4,eastern ky.,3184
2012,124,San Jose St.,30,11,19,1933,64.4,san jose st.,3363
2012,125,Sacred Heart,33,25,8,2125,64.4,sacred heart,3357
2012,126,James Madison,37,29,8,2378,64.3,james madison,3241
2012,127,CSUN,31,17,14,1992,64.3,lsu,3261
2012,128,Sam Houston St.,30,18,12,1927,64.2,sam houston st.,3358
2012,129,Northwestern,30,14,16,1923,64.1,northwestern,3321
2012,130,Toledo,34,24,10,2179,64.1,toledo,3405
2012,131,Portland,32,12,20,2048,64,portland,3339
2012,131,Southern California,30,18,12,1920,64,southern california,3425
2012,133,UNC Asheville,30,7,23,1918,63.9,unc asheville,3421
2012,134,St. Bonaventure,35,31,4,2235,63.9,st. bonaventure,3382
2012,135,West Virginia,34,24,10,2169,63.8,west virginia,3452
2012,136,FIU,34,23,11,2168,63.8,fiu,3198
2012,137,Wichita St.,33,20,13,2098,63.6,wichita st.,3455
2012,138,South Fla.,35,19,16,2225,63.6,south fla.,3378
2012,139,Illinois,30,11,19,1903,63.4,illinois,3228
2012,140,Michigan,32,20,12,2029,63.4,michigan,3276
2012,141,UNCW,33,20,13,2091,63.4,unc,3314
2012,142,Virginia,36,25,11,2281,63.4,virginia,3438
2012,143,Southeastern La.,30,12,18,1899,63.3,southeastern la.,3368
2012,144,Washington,34,20,14,2151,63.3,washington,3449
2012,145,George Mason,31,15,16,1959,63.2,george mason,3206
2012,146,Ill.-Chicago,31,18,13,1955,63.1,ill.-chicago,3227
2012,147,Holy Cross,34,19,15,2144,63.1,holy cross,3221
2012,148,Coppin St.,32,20,12,2017,63,coppin st.,3164
2012,149,Jacksonville,31,11,20,1953,63,jacksonville,3239
2012,150,Iona,31,13,18,1951,62.9,iona,3233
2012,151,Elon,30,16,14,1887,62.9,elon,3189
2012,152,Southern Ill.,30,8,22,1886,62.9,southern ill.,3356
2012,153,Davidson,32,22,10,2011,62.8,davidson,3172
2012,154,Kennesaw St.,31,14,17,1945,62.7,kennesaw st.,3244
2012,155,Iowa St.,31,18,13,1944,62.7,iowa st.,3235
2012,156,LIU Brooklyn,31,21,10,1943,62.7,liu brooklyn,3254
2012,157,Northeastern,30,8,22,1879,62.6,northeastern,3318
2012,158,Old Dominion,32,11,21,2004,62.6,old dominion,3330
2012,159,UNLV,32,22,10,2003,62.6,unlv,3424
2012,160,Norfolk St.,29,12,17,1813,62.5,norfolk st.,3313
2012,161,Western Mich.,30,8,22,1868,62.3,western mich.,3444
2012,162,LSU,34,23,11,2115,62.2,lsu,3261
2012,163,Montana,30,16,14,1865,62.2,montana,3285
2012,164,Chattanooga,32,22,10,1988,62.1,chattanooga,3151
2012,165,UCLA,30,14,16,1863,62.1,ucla,3417
2012,166,Buffalo,31,9,22,1925,62.1,buffalo,3138
2012,167,Arkansas,33,24,9,2049,62.1,arkansas,3116
2012,168,Tulane,34,23,11,2109,62,tulane,3408
2012,169,Idaho St.,32,24,8,1984,62,idaho st.,3226
2012,170,Morgan St.,30,6,24,1859,62,morgan st.,3288
2012,171,Idaho,32,12,20,1982,61.9,idaho,3225
2012,172,Weber St.,29,2,27,1795,61.9,weber st.,3451
2012,173,Georgia St.,30,8,22,1853,61.8,georgia st.,3209
2012,174,San Francisco,30,5,25,1852,61.7,san francisco,3362
2012,175,Fort Wayne,30,9,21,1846,61.5,iupu-fort wayne,3236
2012,176,St. John's (NY),34,24,10,2092,61.5,st. john's (ny),3385
2012,177,Grambling,30,15,15,1843,61.4,grambling,3212
2012,178,Southern Miss.,31,13,18,1902,61.4,southern miss.,3379
2012,179,Monmouth,32,19,13,1960,61.3,monmouth,3284
2012,180,South Carolina,35,25,10,2143,61.2,south carolina,3376
2012,181,South Carolina St.,29,13,16,1775,61.2,south carolina st.,3354
2012,182,North Dakota St.,31,11,20,1896,61.2,north dakota st.,3295
2012,183,Brown,28,16,12,1712,61.1,brown,3135
2012,184,UC Davis,30,17,13,1833,61.1,uc davis,3413
2012,185,Missouri,31,13,18,1894,61.1,missouri,3281
2012,186,Furman,31,15,16,1893,61.1,furman,3202
2012,187,Cal St. Fullerton,30,11,19,1830,61,cal st. fullerton,3168
2012,188,A&M-Corpus Christi,29,9,20,1766,60.9,a&m-corpus chris,3394
2012,189,Rutgers,32,22,10,1948,60.9,rutgers,3353
2012,190,Creighton,33,20,13,2003,60.7,creighton,3166
2012,191,Colorado,35,21,14,2124,60.7,colorado,3160
2012,192,North Texas,31,15,16,1878,60.6,north texas,3317
2012,193,Indiana St.,31,15,16,1875,60.5,indiana st.,3232
2012,193,Denver,31,19,12,1875,60.5,denver,3176
2012,195,Utah Valley,30,15,15,1814,60.5,utah valley,3430
2012,196,Colorado St.,30,13,17,1812,60.4,colorado st.,3161
2012,197,Georgetown,32,23,9,1932,60.4,georgetown,3207
2012,198,UMBC,32,17,15,1931,60.3,umbc,3420
2012,199,Washington St.,33,13,20,1989,60.3,washington st.,3450
2012,200,USC Upstate,30,9,21,1808,60.3,usc upstate,3367
2012,201,Alabama A&M,29,17,12,1746,60.2,alabama a&m,3105
2012,202,TCU,30,16,14,1803,60.1,tcu,3395
2012,203,Samford,33,20,13,1978,59.9,samford,3359
2012,204,La.-Monroe,30,9,21,1798,59.9,la.-monroe,3419
2012,205,Pepperdine,29,14,15,1737,59.9,pepperdine,3337
2012,206,Tulsa,28,13,15,1674,59.8,tulsa,3409
2012,207,IUPUI,32,13,19,1913,59.8,iupui,3237
2012,208,Long Beach St.,32,14,18,1910,59.7,long beach st.,3253
2012,209,Prairie View,33,17,16,1969,59.7,prairie view,3341
2012,210,Mercer,29,6,23,1730,59.7,mercer,3273
2012,211,Rice,32,16,16,1908,59.6,rice,3349
2012,212,Central Conn. St.,29,13,16,1729,59.6,central conn. st.,3148
2012,213,Boston U.,32,23,9,1906,59.6,boston u.,3131
2012,214,Marshall,30,16,14,1784,59.5,marshall,3267
2012,215,Cleveland St.,31,12,19,1843,59.5,cleveland st.,3156
2012,216,Drexel,33,19,14,1961,59.4,drexel,3180
2012,217,Alabama,31,12,19,1840,59.4,alabama,3104
2012,218,Lehigh,30,17,13,1780,59.3,lehigh,3250
2012,219,Ohio,32,14,18,1897,59.3,ohio,3325
2012,220,Wisconsin,29,9,20,1719,59.3,wisconsin,3458
2012,221,SMU,31,14,17,1837,59.3,smu,3374
2012,222,Wofford,31,13,18,1836,59.2,wofford,3459
2012,222,Lamar University,31,16,15,1836,59.2,american university,3110
2012,224,Coastal Caro.,28,13,15,1657,59.2,coastal caro.,3157
2012,225,Drake,34,18,16,2012,59.2,drake,3179
2012,226,Vermont,30,10,20,1774,59.1,vermont,3436
2012,227,Northern Colo.,32,20,12,1892,59.1,northern colo.,3294
2012,228,South Ala.,30,17,13,1772,59.1,south ala.,3375
2012,229,Saint Louis,31,11,20,1831,59.1,saint louis,3387
2012,230,East Carolina,31,12,19,1827,58.9,east carolina,3187
2012,231,Xavier,28,8,20,1650,58.9,xavier,3462
2012,232,Hawaii,30,11,19,1766,58.9,hawaii,3218
2012,233,Marquette,31,14,17,1821,58.7,marquette,3266
2012,234,Ball St.,30,9,21,1762,58.7,ball st.,3123
2012,235,Howard,33,24,9,1937,58.7,howard,3224
2012,236,Wyoming,29,12,17,1702,58.7,wyoming,3461
2012,237,La Salle,31,14,17,1817,58.6,la salle,3247
2012,238,Butler,30,13,17,1758,58.6,butler,3139
2012,239,Lipscomb,29,6,23,1699,58.6,lipscomb,3252
2012,240,Auburn,30,13,17,1755,58.5,auburn,3120
2012,241,George Washington,29,11,18,1696,58.5,george washington,3203
2012,242,Utah,32,16,16,1870,58.4,utah,3428
2012,243,Colgate,30,8,22,1753,58.4,colgate,3159
2012,243,New Hampshire,30,16,14,1753,58.4,new hampshire,3306
2012,245,Southern Utah,29,6,23,1694,58.4,southern utah,3381
2012,246,Albany (NY),33,23,10,1925,58.3,albany (ny),3107
2012,246,Loyola Maryland,30,13,17,1750,58.3,loyola maryland,3259
2012,248,Mt. St. Mary's,30,14,16,1749,58.3,mt. st. mary's,3291
2012,249,Fairleigh Dickinson,31,13,18,1801,58.1,fairleigh dickinson,3192
2012,250,Loyola Marymount,30,8,22,1741,58,loyola marymount,3258
2012,251,Arkansas St.,30,12,18,1739,58,arkansas st.,3117
2012,252,Milwaukee,30,9,21,1737,57.9,milwaukee,3454
2012,253,Arizona St.,32,20,12,1851,57.8,arizona st.,3113
2012,254,Siena,29,12,17,1674,57.7,siena,3373
2012,255,Villanova,34,19,15,1961,57.7,villanova,3437
2012,256,Ole Miss,30,12,18,1730,57.7,ole miss,3279
2012,257,American,31,23,8,1787,57.6,american,3110
2012,258,NJIT,30,13,17,1729,57.6,njit,3312
2012,259,Little Rock,33,20,13,1901,57.6,little rock,3114
2012,260,Towson,30,16,14,1728,57.6,towson,3406
2012,260,Indiana,30,6,24,1728,57.6,indiana,3231
2012,262,Massachusetts,29,8,21,1669,57.6,massachusetts,3269
2012,263,Canisius,30,12,18,1726,57.5,canisius,3145
2012,264,Kent St.,27,6,21,1548,57.3,kent st.,3245
2012,265,Kansas St.,34,20,14,1942,57.1,kansas st.,3243
2012,266,Cincinnati,32,16,16,1827,57.1,cincinnati,3153
2012,267,Southern U.,26,13,13,1483,57,southern u.,3380
2012,268,Manhattan,34,18,16,1939,57,manhattan,3264
2012,269,Oakland,28,11,17,1596,57,oakland,3324
2012,270,Jacksonville St.,29,4,25,1651,56.9,jacksonville st.,3240
2012,271,Mississippi St.,30,14,16,1705,56.8,mississippi st.,3280
2012,272,UTSA,29,8,21,1648,56.8,utsa,3427
2012,273,Pittsburgh,30,8,22,1704,56.8,pittsburgh,3338
2012,274,Boston College,30,7,23,1703,56.8,boston college,3130
2012,275,Northern Ill.,31,14,17,1758,56.7,northern ill.,3296
2012,276,Jackson St.,28,11,17,1586,56.6,jackson st.,3238
2012,277,North Florida,30,13,17,1696,56.5,north florida,3316
2012,278,Delaware St.,30,7,23,1695,56.5,delaware st.,3175
2012,279,Army West Point,30,14,16,1692,56.4,armstrong,3118
2012,280,Fla. Atlantic,30,17,13,1691,56.4,fla. atlantic,3194
2012,281,Western Ky.,30,9,21,1689,56.3,western ky.,3443
2012,282,Belmont,30,12,18,1678,55.9,belmont,3125
2012,283,Hartford,32,19,13,1789,55.9,hartford,3216
2012,284,Bethune-Cookman,29,10,19,1619,55.8,bethune-cookman,3126
2012,285,Rider,30,11,19,1670,55.7,rider,3351
2012,286,Niagara,32,13,19,1779,55.6,niagara,3310
2012,287,Cornell,28,12,16,1554,55.5,cornell,3165
2012,288,Navy,32,18,14,1773,55.4,navy,3298
2012,289,UTRGV,30,13,17,1662,55.4,utrgv,3410
2012,290,Alcorn,34,14,20,1881,55.3,alcorn,3108
2012,291,UT Arlington,28,6,22,1549,55.3,ut arlington,3426
2012,292,UC Riverside,29,5,24,1599,55.1,uc riverside,3415
2012,293,Chicago St.,30,6,24,1654,55.1,chicago st.,3152
2012,294,Longwood,29,7,22,1598,55.1,longwood,3255
2012,295,UAB,30,19,11,1650,55,uab,3412
2012,296,Providence,30,13,17,1643,54.8,providence,3344
2012,297,UCF,29,12,17,1582,54.6,ucf,3416
2012,298,Seton Hall,31,8,23,1691,54.5,seton hall,3371
2012,299,Fairfield,33,24,9,1800,54.5,fairfield,3193
2012,300,New Mexico,31,11,20,1682,54.3,new mexico,3307
2012,301,Alabama St.,28,14,14,1519,54.3,alabama st.,3106
2012,301,Clemson,28,6,22,1519,54.3,clemson,3155
2012,303,Penn,28,13,15,1515,54.1,penn,3335
2012,304,Air Force,30,6,24,1619,54,air force,3102
2012,305,Dartmouth,28,6,22,1507,53.8,dartmouth,3171
2012,306,New Mexico St.,30,6,24,1613,53.8,new mexico st.,3308
2012,307,Saint Peter's,31,5,26,1662,53.6,saint peter's,3389
2012,308,Evansville,30,5,25,1606,53.5,evansville,3191
2012,309,Wagner,29,2,27,1546,53.3,wagner,3447
2012,310,UC Santa Barbara,33,17,16,1754,53.2,uc santa barbara,3364
2012,311,Lafayette,30,8,22,1594,53.1,lafayette,3248
2012,312,Houston,29,3,26,1535,52.9,houston,3222
2012,313,Binghamton,31,13,18,1629,52.5,binghamton,3127
2012,313,Western Caro.,31,14,17,1629,52.5,western caro.,3441
2012,315,Southeast Mo. St.,29,7,22,1523,52.5,southeast mo. st.,3369
2012,316,Valparaiso,31,10,21,1626,52.5,valparaiso,3434
2012,317,Columbia,28,3,25,1461,52.2,columbia,3162
2012,318,Maine,31,8,23,1617,52.2,maine,3263
2012,319,Louisiana,30,7,23,1563,52.1,se louisiana,3368
2012,320,UMES,30,12,18,1559,52,umes,3271
2012,320,Fordham,30,12,18,1559,52,fordham,3200
2012,322,Ga. Southern,30,8,22,1553,51.8,ga. southern,3204
2012,323,Virginia Tech,30,7,23,1551,51.7,virginia tech,3439
2012,324,Bucknell,30,5,25,1539,51.3,bucknell,3137
2012,325,Gardner-Webb,29,4,25,1474,50.8,gardner-webb,3205
2012,326,Savannah St.,30,10,20,1523,50.8,savannah st.,3366
2012,327,Troy,28,2,26,1396,49.9,troy,3407
2012,328,UNCG,29,4,25,1438,49.6,unc,3314
2012,329,N.C. Central,30,3,27,1486,49.5,n.c. central,3300
2012,330,Rhode Island,29,1,28,1426,49.2,rhode island,3348
2012,331,St. Francis Brooklyn,29,4,25,1404,48.4,st. francis brooklyn,3383
2012,332,Ark.-Pine Bluff,30,1,29,1452,48.4,ark.-pine bluff,3115
2012,333,Col. of Charleston,30,7,23,1421,47.4,col. of charleston,3158
2012,334,Texas Southern,31,5,26,1465,47.3,texas southern,3411
2012,335,Houston Baptist,28,1,27,1252,44.7,houston baptist,3223
2012,336,Stony Brook,30,4,26,1300,43.3,stony brook,3392
2013,1,UConn,39,35,4,3218,82.5,uconn,3163
2013,2,Notre Dame,37,35,2,3003,81.2,notre dame,3323
2013,3,Baylor,36,34,2,2921,81.1,baylor,3124
2013,4,Tennessee,35,27,8,2717,77.6,tennessee,3397
2013,5,Utah St.,32,18,14,2448,76.5,utah st.,3429
2013,6,Dayton,31,28,3,2353,75.9,dayton,3173
2013,7,Akron,33,23,10,2488,75.4,akron,3103
2013,8,Kentucky,36,30,6,2713,75.4,kentucky,3246
2013,9,Maryland,34,26,8,2549,75,maryland,3268
2013,10,Florida St.,33,23,10,2469,74.8,florida st.,3199
2013,11,Duke,36,33,3,2683,74.5,duke,3181
2013,12,Central Mich.,33,21,12,2454,74.4,central mich.,3141
2013,13,Penn St.,32,26,6,2356,73.6,penn st.,3336
2013,14,Oklahoma St.,33,22,11,2423,73.4,oklahoma st.,3329
2013,15,UT Martin,34,19,15,2482,73,ut martin,3404
2013,16,Oklahoma,35,24,11,2542,72.6,oklahoma,3328
2013,17,Sacramento St.,31,19,12,2243,72.4,sacramento st.,3170
2013,18,Syracuse,32,24,8,2304,72,syracuse,3393
2013,19,California,36,32,4,2586,71.8,california,3143
2013,20,Louisville,38,29,9,2726,71.7,louisville,3257
2013,21,Bradley,30,14,16,2139,71.3,bradley,3133
2013,22,Princeton,29,22,7,2065,71.2,princeton,3343
2013,23,Liberty,34,27,7,2418,71.1,liberty,3251
2013,24,DePaul,33,21,12,2337,70.8,depaul,3177
2013,25,Florida,37,22,15,2611,70.6,florida,3196
2013,26,Quinnipiac,33,30,3,2327,70.5,quinnipiac,3346
2013,27,Stanford,36,33,3,2538,70.5,stanford,3390
2013,28,Missouri St.,31,14,17,2176,70.2,missouri st.,3283
2013,28,Troy,31,7,24,2176,70.2,troy,3407
2013,30,Detroit Mercy,34,21,13,2386,70.2,detroit mercy,3178
2013,31,Wyoming,32,24,8,2245,70.2,wyoming,3461
2013,32,FGCU,34,27,7,2384,70.1,fgcu,3195
2013,33,Kansas,34,20,14,2377,69.9,kansas,3242
2013,34,Texas A&M,35,25,10,2445,69.9,texas a&m,3401
2013,35,Oral Roberts,31,18,13,2160,69.7,oral roberts,3331
2013,35,Southern Utah,31,15,16,2160,69.7,southern utah,3381
2013,37,South Fla.,33,22,11,2296,69.6,south fla.,3378
2013,38,Texas St.,30,10,20,2084,69.5,texas st.,3402
2013,39,Minnesota,32,18,14,2221,69.4,minnesota,3278
2013,40,Gonzaga,33,27,6,2283,69.2,gonzaga,3211
2013,41,Pacific,35,27,8,2416,69,pacific,3334
2013,42,LSU,34,22,12,2346,69,lsu,3261
2013,43,Illinois,33,19,14,2275,68.9,illinois,3228
2013,44,NC State,34,17,17,2343,68.9,nc state,3301
2013,45,North Carolina,36,29,7,2479,68.9,north carolina,3314
2013,46,Winthrop,33,21,12,2271,68.8,winthrop,3457
2013,47,Appalachian St.,31,20,11,2131,68.7,appalachian st.,3111
2013,48,Western Ky.,33,22,11,2268,68.7,western ky.,3443
2013,49,Stetson,33,24,9,2266,68.7,stetson,3391
2013,50,Chattanooga,33,29,4,2262,68.5,chattanooga,3151
2013,51,SMU,31,21,10,2120,68.4,smu,3374
2013,52,Memphis,32,17,15,2188,68.4,memphis,3272
2013,53,San Diego St.,34,27,7,2324,68.4,san diego st.,3361
2013,54,McNeese,36,21,15,2459,68.3,mcneese st,3270
2013,55,James Madison,36,25,11,2457,68.3,james madison,3241
2013,56,Fresno St.,33,24,9,2252,68.2,fresno st.,3201
2013,57,Eastern Ill.,32,20,12,2182,68.2,eastern ill.,3183
2013,58,Fla. Atlantic,29,12,17,1973,68,fla. atlantic,3194
2013,59,CSU Bakersfield,29,12,17,1972,68,cs bakersfield,3167
2013,60,Purdue,34,25,9,2308,67.9,purdue,3345
2013,61,Green Bay,32,29,3,2172,67.9,green bay,3453
2013,62,Cal Poly,32,21,11,2167,67.7,cal poly,3142
2013,63,Wake Forest,32,13,19,2164,67.6,wake forest,3448
2013,64,Harvard,30,21,9,2028,67.6,harvard,3217
2013,64,Georgia Tech,30,14,16,2028,67.6,georgia tech,3210
2013,66,Iowa,34,21,13,2296,67.5,iowa,3234
2013,67,UCLA,34,26,8,2294,67.5,ucla,3417
2013,68,Seattle U,31,20,11,2090,67.4,seattle,3370
2013,69,San Jose St.,30,11,19,2022,67.4,san jose st.,3363
2013,70,Iowa St.,33,24,9,2223,67.4,iowa st.,3235
2013,71,Middle Tenn.,33,25,8,2214,67.1,middle tenn.,3292
2013,72,Nebraska,34,25,9,2279,67,nebraska,3304
2013,73,Northeastern,30,17,13,2010,67,northeastern,3318
2013,74,Delaware,36,32,4,2411,67,delaware,3174
2013,75,Albany (NY),31,27,4,2074,66.9,albany (ny),3107
2013,76,Cleveland St.,30,13,17,2005,66.8,cleveland st.,3156
2013,77,South Dakota St.,33,25,8,2205,66.8,south dakota st.,3355
2013,78,Illinois St.,35,24,11,2336,66.7,illinois st.,3229
2013,79,Tennessee Tech,31,19,12,2068,66.7,tennessee tech,3399
2013,80,North Texas,30,11,19,2000,66.7,north texas,3317
2013,81,Campbell,31,20,11,2066,66.6,campbell,3144
2013,82,UTEP,32,22,10,2128,66.5,utep,3431
2013,82,San Diego,32,22,10,2128,66.5,san diego,3360
2013,84,Charlotte,32,26,6,2126,66.4,charlotte,3150
2013,85,Ohio St.,31,18,13,2058,66.4,ohio st.,3326
2013,86,Arkansas,33,20,13,2189,66.3,arkansas,3116
2013,87,Georgia,35,28,7,2320,66.3,georgia,3208
2013,88,Tulane,33,24,9,2182,66.1,tulane,3408
2013,89,Auburn,34,19,15,2246,66.1,auburn,3120
2013,90,Drake,31,11,20,2047,66,drake,3179
2013,91,Denver,31,14,17,2046,66,denver,3176
2013,92,Loyola Chicago,32,17,15,2109,65.9,loyola chicago,3260
2013,93,Murray St.,29,16,13,1909,65.8,murray st.,3293
2013,94,Elon,33,19,14,2168,65.7,elon,3189
2013,94,Vanderbilt,33,21,12,2168,65.7,vanderbilt,3435
2013,94,Creighton,33,25,8,2168,65.7,creighton,3166
2013,97,Nicholls St.,30,19,11,1970,65.7,nicholls st.,3311
2013,98,Missouri,32,17,15,2100,65.6,missouri,3281
2013,99,Toledo,33,29,4,2165,65.6,toledo,3405
2013,100,Milwaukee,29,9,20,1902,65.6,milwaukee,3454
2013,101,Miami (OH),32,19,13,2097,65.5,miami (oh),3275
2013,102,East Carolina,32,22,10,2093,65.4,east carolina,3187
2013,103,Washington,33,21,12,2156,65.3,washington,3449
2013,104,Texas Tech,32,21,11,2089,65.3,texas tech,3403
2013,105,High Point,30,17,13,1957,65.2,high point,3219
2013,106,Loyola Marymount,31,13,18,2022,65.2,loyola marymount,3258
2013,107,Iona,33,20,13,2148,65.1,iona,3233
2013,108,Old Dominion,31,19,12,2016,65,old dominion,3330
2013,109,Colorado,32,25,7,2081,65,colorado,3160
2013,109,Miami (FL),32,21,11,2081,65,miami (fl),3274
2013,111,Alabama,31,13,18,2013,64.9,alabama,3104
2013,112,Idaho,33,17,16,2139,64.8,idaho,3225
2013,113,Wright St.,30,12,18,1943,64.8,wright st.,3460
2013,114,Eastern Wash.,32,19,13,2072,64.8,eastern wash.,3186
2013,115,Ole Miss,29,9,20,1877,64.7,ole miss,3279
2013,116,Montana,32,24,8,2070,64.7,montana,3285
2013,117,Saint Joseph's,32,23,9,2065,64.5,saint joseph's,3386
2013,118,Western Ill.,30,14,16,1935,64.5,western ill.,3442
2013,119,Saint Francis (PA),33,17,16,2128,64.5,saint francis (pa),3384
2013,120,Saint Mary's (CA),34,23,11,2186,64.3,saint mary's (ca),3388
2013,121,Yale,28,13,15,1800,64.3,yale,3463
2013,122,Hampton,34,28,6,2180,64.1,hampton,3214
2013,123,Southeastern La.,29,11,18,1857,64,southeastern la.,3368
2013,124,BYU,34,23,11,2175,64,byu,3140
2013,125,Marist,33,26,7,2109,63.9,marist,3265
2013,126,Longwood,33,14,19,2108,63.9,longwood,3255
2013,127,West Virginia,31,17,14,1978,63.8,west virginia,3452
2013,128,South Dakota,35,19,16,2231,63.7,south dakota,3377
2013,129,Marquette,32,16,16,2039,63.7,marquette,3266
2013,130,Lamar University,33,22,11,2100,63.6,american university,3110
2013,131,ETSU,26,8,18,1650,63.5,etsu,3190
2013,132,Houston,30,13,17,1903,63.4,houston,3222
2013,133,Southern Miss.,31,15,16,1965,63.4,southern miss.,3379
2013,134,Tulsa,34,17,17,2155,63.4,tulsa,3409
2013,135,Youngstown St.,33,23,10,2090,63.3,youngstown st.,3464
2013,136,Hofstra,31,14,17,1963,63.3,hofstra,3220
2013,137,UNI,34,17,17,2148,63.2,uni,3320
2013,138,Ill.-Chicago,30,9,21,1894,63.1,ill.-chicago,3227
2013,139,San Francisco,31,12,19,1952,63,san francisco,3362
2013,139,UNLV,31,12,19,1952,63,unlv,3424
2013,141,Jacksonville,30,11,19,1889,63,jacksonville,3239
2013,142,Utah Valley,30,15,15,1888,62.9,utah valley,3430
2013,143,Little Rock,33,24,9,2076,62.9,little rock,3114
2013,144,Montana St.,30,17,13,1886,62.9,montana st.,3286
2013,145,Louisiana Tech,31,14,17,1947,62.8,louisiana tech,3256
2013,146,Portland St.,29,12,17,1821,62.8,portland st.,3340
2013,147,IUPUI,32,20,12,2008,62.8,iupui,3237
2013,148,Davidson,35,22,13,2195,62.7,davidson,3172
2013,149,Sam Houston St.,33,18,15,2069,62.7,sam houston st.,3358
2013,150,Central Ark.,30,15,15,1879,62.6,central ark.,3146
2013,150,Fort Wayne,30,13,17,1879,62.6,iupu-fort wayne,3236
2013,152,Georgetown,31,15,16,1940,62.6,georgetown,3207
2013,153,Sacred Heart,33,22,11,2065,62.6,sacred heart,3357
2013,154,Bryant,30,12,18,1877,62.6,bryant,3136
2013,155,Arizona,30,12,18,1875,62.5,arizona,3112
2013,156,SFA,31,14,17,1936,62.5,utsa,3427
2013,157,Col. of Charleston,32,16,16,1995,62.3,col. of charleston,3158
2013,158,SIUE,31,16,15,1931,62.3,siena,3373
2013,159,Bowling Green,35,24,11,2178,62.2,bowling green,3132
2013,160,New Mexico St.,31,15,16,1928,62.2,new mexico st.,3308
2013,161,Valparaiso,31,11,20,1926,62.1,valparaiso,3434
2013,162,South Carolina St.,29,20,9,1801,62.1,south carolina st.,3354
2013,163,Boise St.,30,11,19,1861,62,boise st.,3129
2013,164,Mississippi Val.,32,17,15,1985,62,mississippi val.,3290
2013,165,Tennessee St.,28,13,15,1735,62,tennessee st.,3398
2013,166,Coppin St.,32,16,16,1982,61.9,coppin st.,3164
2013,167,Boston College,31,12,19,1920,61.9,boston college,3130
2013,168,Virginia,30,16,14,1857,61.9,virginia,3438
2013,169,Boston U.,30,24,6,1856,61.9,boston u.,3131
2013,170,N.C. A&T,32,22,10,1977,61.8,n.c. a&t,3299
2013,171,Michigan St.,34,25,9,2097,61.7,michigan st.,3277
2013,172,Richmond,32,16,16,1973,61.7,richmond,3350
2013,173,St. John's (NY),31,18,13,1911,61.6,st. john's (ny),3385
2013,174,Texas,30,12,18,1848,61.6,texas,3400
2013,175,Southern California,31,11,20,1905,61.5,southern california,3425
2013,176,Arkansas St.,30,15,15,1842,61.4,arkansas st.,3117
2013,177,UCF,34,16,18,2087,61.4,ucf,3416
2013,178,Northern Ariz.,29,8,21,1780,61.4,northern ariz.,3319
2013,178,Georgia St.,29,13,16,1780,61.4,georgia st.,3209
2013,180,Radford,30,16,14,1841,61.4,radford,3347
2013,180,Northwestern,30,13,17,1841,61.4,northwestern,3321
2013,182,Idaho St.,31,18,13,1902,61.4,idaho st.,3226
2013,183,South Carolina,33,25,8,2024,61.3,south carolina,3376
2013,184,Morgan St.,31,13,18,1901,61.3,morgan st.,3288
2013,185,Eastern Ky.,30,18,12,1838,61.3,eastern ky.,3184
2013,186,Nevada,31,8,23,1899,61.3,nevada,3305
2013,187,FIU,32,19,13,1960,61.3,fiu,3198
2013,187,Belmont,32,18,14,1960,61.3,belmont,3125
2013,189,UAB,31,18,13,1897,61.2,uab,3412
2013,190,Kansas St.,37,19,18,2264,61.2,kansas st.,3243
2013,191,Buffalo,32,12,20,1957,61.2,buffalo,3138
2013,192,Central Conn. St.,30,16,14,1834,61.1,central conn. st.,3148
2013,193,La.-Monroe,31,10,21,1895,61.1,la.-monroe,3419
2013,194,Wichita St.,34,24,10,2078,61.1,wichita st.,3455
2013,195,William & Mary,30,8,22,1833,61.1,william & mary,3456
2013,196,Duquesne,32,24,8,1955,61.1,duquesne,3182
2013,197,Florida A&M,30,11,19,1831,61,florida a&m,3197
2013,198,Texas Southern,32,20,12,1953,61,texas southern,3411
2013,199,UTSA,30,16,14,1825,60.8,utsa,3427
2013,200,Oregon,31,4,27,1885,60.8,oregon,3332
2013,201,Southern Ill.,31,5,26,1884,60.8,southern ill.,3356
2013,202,Charleston So.,28,8,20,1701,60.8,charleston so.,3149
2013,203,Austin Peay,28,7,21,1700,60.7,austin peay,3122
2013,204,UC Davis,30,12,18,1821,60.7,uc davis,3413
2013,205,Rider,30,15,15,1813,60.4,rider,3351
2013,206,UC Riverside,29,11,18,1750,60.3,uc riverside,3415
2013,207,Houston Baptist,31,7,24,1869,60.3,houston baptist,3223
2013,208,Jackson St.,28,12,16,1686,60.2,jackson st.,3238
2013,209,Xavier,29,13,16,1746,60.2,xavier,3462
2013,210,Michigan,33,22,11,1984,60.1,michigan,3276
2013,211,Long Beach St.,32,16,16,1920,60,long beach st.,3253
2013,211,Grambling,32,9,23,1920,60,grambling,3212
2013,211,Portland,31,11,20,1860,60,portland,3339
2013,211,North Dakota St.,29,10,19,1740,60,north dakota st.,3295
2013,215,Gardner-Webb,31,13,18,1858,59.9,gardner-webb,3205
2013,216,Northern Colo.,34,21,13,2036,59.9,northern colo.,3294
2013,217,Holy Cross,32,18,14,1916,59.9,holy cross,3221
2013,218,Santa Clara,30,14,16,1796,59.9,santa clara,3365
2013,219,Drexel,38,28,10,2273,59.8,drexel,3180
2013,220,Mercer,32,20,12,1913,59.8,mercer,3273
2013,221,TCU,30,9,21,1792,59.7,tcu,3395
2013,222,UTRGV,28,12,16,1671,59.7,utrgv,3410
2013,223,Furman,30,12,18,1790,59.7,furman,3202
2013,224,Monmouth,30,15,15,1786,59.5,monmouth,3284
2013,225,Providence,30,7,23,1784,59.5,providence,3344
2013,226,CSUN,32,16,16,1902,59.4,lsu,3261
2013,227,North Dakota,29,11,18,1723,59.4,north dakota,3315
2013,228,Washington St.,31,11,20,1841,59.4,washington st.,3450
2013,229,Southeast Mo. St.,29,11,18,1722,59.4,southeast mo. st.,3369
2013,230,Villanova,32,21,11,1898,59.3,villanova,3437
2013,231,Prairie View,32,17,15,1895,59.2,prairie view,3341
2013,232,VCU,30,11,19,1774,59.1,vcu,3433
2013,233,Hawaii,31,17,14,1832,59.1,hawaii,3218
2013,234,USC Upstate,30,12,18,1772,59.1,usc upstate,3367
2013,235,Butler,31,17,14,1830,59,butler,3139
2013,236,Utah,37,23,14,2183,59,utah,3428
2013,237,New Mexico,31,17,14,1827,58.9,new mexico,3307
2013,238,George Washington,30,14,16,1767,58.9,george washington,3203
2013,239,Arizona St.,31,13,18,1825,58.9,arizona st.,3113
2013,240,Ball St.,33,17,16,1942,58.8,ball st.,3123
2013,241,UT Arlington,30,7,23,1765,58.8,ut arlington,3426
2013,242,Ark.-Pine Bluff,31,13,18,1823,58.8,ark.-pine bluff,3115
2013,243,Pittsburgh,30,9,21,1761,58.7,pittsburgh,3338
2013,244,Indiana St.,31,18,13,1819,58.7,indiana st.,3232
2013,244,Western Mich.,31,11,20,1819,58.7,western mich.,3444
2013,246,Fordham,35,26,9,2053,58.7,fordham,3200
2013,247,Penn,31,18,13,1815,58.5,penn,3335
2013,247,Mt. St. Mary's,31,15,16,1815,58.5,mt. st. mary's,3291
2013,249,Evansville,30,9,21,1749,58.3,evansville,3191
2013,250,Wisconsin,31,12,19,1799,58,wisconsin,3458
2013,251,Navy,33,21,12,1913,58,navy,3298
2013,252,Hartford,33,21,12,1907,57.8,hartford,3216
2013,253,Alabama A&M,29,9,20,1673,57.7,alabama a&m,3105
2013,254,Fairleigh Dickinson,29,12,17,1665,57.4,fairleigh dickinson,3192
2013,255,Niagara,31,15,16,1778,57.4,niagara,3310
2013,256,Army West Point,31,22,9,1776,57.3,armstrong,3118
2013,256,Oregon St.,31,10,21,1776,57.3,oregon st.,3333
2013,258,Cornell,28,13,15,1601,57.2,cornell,3165
2013,259,South Ala.,30,17,13,1715,57.2,south ala.,3375
2013,259,Southern U.,30,13,17,1715,57.2,southern u.,3380
2013,261,UNCG,31,8,23,1772,57.2,unc,3314
2013,262,Louisiana,31,10,21,1771,57.1,se louisiana,3368
2013,263,Rice,30,14,16,1713,57.1,rice,3349
2013,264,Coastal Caro.,29,13,16,1654,57,coastal caro.,3157
2013,265,Canisius,31,12,19,1768,57,canisius,3145
2013,266,Alabama St.,30,9,21,1706,56.9,alabama st.,3106
2013,267,American,29,15,14,1649,56.9,american,3110
2013,268,Towson,30,12,18,1701,56.7,towson,3406
2013,269,Siena,31,13,18,1754,56.6,siena,3373
2013,270,Air Force,30,4,26,1697,56.6,air force,3102
2013,271,Massachusetts,29,3,26,1636,56.4,massachusetts,3269
2013,272,Jacksonville St.,28,1,27,1578,56.4,jacksonville st.,3240
2013,273,Eastern Mich.,30,8,22,1688,56.3,eastern mich.,3185
2013,273,Colorado St.,30,11,19,1688,56.3,colorado st.,3161
2013,275,Delaware St.,31,10,21,1742,56.2,delaware st.,3175
2013,276,Lehigh,30,14,16,1684,56.1,lehigh,3250
2013,277,Wofford,29,8,21,1627,56.1,wofford,3459
2013,278,St. Francis Brooklyn,30,11,19,1681,56,st. francis brooklyn,3383
2013,278,Morehead St.,30,9,21,1681,56,morehead st.,3287
2013,280,Bucknell,31,15,16,1736,56,bucknell,3137
2013,281,Rutgers,30,16,14,1679,56,rutgers,3353
2013,282,Robert Morris,29,7,22,1623,56,robert morris,3352
2013,282,Oakland,29,9,20,1623,56,oakland,3324
2013,284,Howard,32,20,12,1775,55.5,howard,3224
2013,285,Marshall,30,9,21,1661,55.4,marshall,3267
2013,286,Maine,28,4,24,1546,55.2,maine,3263
2013,287,Mississippi St.,30,13,17,1656,55.2,mississippi st.,3280
2013,288,Indiana,30,11,19,1655,55.2,indiana,3231
2013,289,Pepperdine,28,5,23,1537,54.9,pepperdine,3337
2013,290,Ohio,29,6,23,1589,54.8,ohio,3325
2013,291,St. Bonaventure,29,10,19,1588,54.8,st. bonaventure,3382
2013,291,Norfolk St.,29,7,22,1588,54.8,norfolk st.,3313
2013,293,UMBC,30,10,20,1642,54.7,umbc,3420
2013,294,LIU Brooklyn,29,7,22,1585,54.7,liu brooklyn,3254
2013,295,George Mason,30,9,21,1635,54.5,george mason,3206
2013,296,Temple,32,14,18,1743,54.5,temple,3396
2013,297,New Hampshire,30,12,18,1634,54.5,new hampshire,3306
2013,298,Clemson,30,9,21,1631,54.4,clemson,3155
2013,299,Northern Ill.,30,7,23,1630,54.3,northern ill.,3296
2013,300,Presbyterian,31,19,12,1683,54.3,presbyterian,3342
2013,301,New Orleans,26,3,23,1411,54.3,new orleans,3309
2013,302,Bethune-Cookman,29,12,17,1567,54,bethune-cookman,3126
2013,303,NJIT,31,16,15,1675,54,njit,3312
2013,303,Saint Louis,31,12,19,1675,54,saint louis,3387
2013,305,Fairfield,32,18,14,1726,53.9,fairfield,3193
2013,306,Cal St. Fullerton,33,11,22,1779,53.9,cal st. fullerton,3168
2013,307,UC Irvine,30,9,21,1617,53.9,uc irvine,3414
2013,308,Samford,31,15,16,1670,53.9,samford,3359
2013,309,La Salle,29,8,21,1562,53.9,la salle,3247
2013,310,Northwestern St.,30,12,18,1609,53.6,northwestern st.,3322
2013,311,UNCW,31,5,26,1659,53.5,unc,3314
2013,312,Ga. Southern,31,8,23,1652,53.3,ga. southern,3204
2013,313,Seton Hall,31,11,20,1648,53.2,seton hall,3371
2013,314,UMKC,30,9,21,1594,53.1,umkc,3282
2013,315,Cincinnati,30,12,18,1592,53.1,cincinnati,3153
2013,315,Loyola Maryland,30,12,18,1592,53.1,loyola maryland,3259
2013,317,Stony Brook,30,14,16,1590,53,stony brook,3392
2013,318,Saint Peter's,30,2,28,1589,53,saint peter's,3389
2013,319,Brown,28,9,19,1481,52.9,brown,3135
2013,320,Weber St.,29,0,29,1533,52.9,weber st.,3451
2013,321,Colgate,31,10,21,1636,52.8,colgate,3159
2013,322,UMES,28,8,20,1477,52.8,umes,3271
2013,323,Lafayette,30,11,19,1564,52.1,lafayette,3248
2013,324,Dartmouth,28,6,22,1456,52,dartmouth,3171
2013,325,North Florida,31,12,19,1606,51.8,north florida,3316
2013,326,Kennesaw St.,31,7,24,1593,51.4,kennesaw st.,3244
2013,327,UC Santa Barbara,33,16,17,1693,51.3,uc santa barbara,3364
2013,328,Manhattan,31,8,23,1590,51.3,manhattan,3264
2013,329,Wagner,29,3,26,1484,51.2,wagner,3447
2013,330,Binghamton,30,6,24,1532,51.1,binghamton,3127
2013,331,Vermont,31,10,21,1581,51,vermont,3436
2013,332,UNC Asheville,30,2,28,1519,50.6,unc asheville,3421
2013,333,Lipscomb,29,3,26,1467,50.6,lipscomb,3252
2013,334,Western Caro.,30,7,23,1517,50.6,western caro.,3441
2013,335,Kent St.,30,3,27,1504,50.1,kent st.,3245
2013,336,Savannah St.,30,7,23,1498,49.9,savannah st.,3366
2013,337,A&M-Corpus Christi,29,4,25,1442,49.7,a&m-corpus chris,3394
2013,338,Virginia Tech,30,10,20,1480,49.3,virginia tech,3439
2013,339,Alcorn,28,2,26,1371,49,alcorn,3108
2013,340,Chicago St.,30,4,26,1458,48.6,chicago st.,3152
2013,341,Rhode Island,29,6,23,1407,48.5,rhode island,3348
2013,342,Columbia,28,5,23,1343,48,columbia,3162
2013,343,N.C. Central,30,2,28,1150,38.3,n.c. central,3300
2014,1,Oregon,32,16,16,2981,93.2,oregon,3332
2014,2,Notre Dame,38,37,1,3271,86.1,notre dame,3323
2014,3,UT Martin,32,24,8,2681,83.8,ut martin,3404
2014,4,Baylor,37,32,5,3093,83.6,baylor,3124
2014,5,DePaul,36,29,7,3006,83.5,depaul,3177
2014,6,Wright St.,35,26,9,2916,83.3,wright st.,3460
2014,7,Sacramento St.,30,18,12,2494,83.1,sacramento st.,3170
2014,8,Saint Francis (PA),32,15,17,2637,82.4,saint francis (pa),3384
2014,9,Central Mich.,32,20,12,2628,82.1,central mich.,3141
2014,10,UConn,40,40,0,3283,82.1,uconn,3163
2014,11,Akron,33,23,10,2706,82,akron,3103
2014,12,Maryland,35,28,7,2864,81.8,maryland,3268
2014,13,Dayton,31,23,8,2528,81.5,dayton,3173
2014,14,Kentucky,35,26,9,2845,81.3,kentucky,3246
2014,15,Troy,30,12,18,2412,80.4,troy,3407
2014,16,Duke,35,28,7,2800,80,duke,3181
2014,17,Western Ill.,30,14,16,2392,79.7,western ill.,3442
2014,18,Georgia Tech,32,20,12,2549,79.7,georgia tech,3210
2014,19,Stetson,35,27,8,2774,79.3,stetson,3391
2014,20,Louisville,38,33,5,2999,78.9,louisville,3257
2014,21,North Carolina,37,27,10,2915,78.8,north carolina,3314
2014,22,Iowa,36,27,9,2814,78.2,iowa,3234
2014,23,Southern Miss.,34,27,7,2657,78.1,southern miss.,3379
2014,24,Tennessee,35,29,6,2725,77.9,tennessee,3397
2014,25,Fla. Atlantic,30,16,14,2331,77.7,fla. atlantic,3194
2014,26,Fort Wayne,30,15,15,2326,77.5,iupu-fort wayne,3236
2014,27,Oklahoma,33,18,15,2557,77.5,oklahoma,3328
2014,28,Utah St.,31,15,16,2396,77.3,utah st.,3429
2014,29,San Jose St.,30,11,19,2308,76.9,san jose st.,3363
2014,30,Stanford,37,33,4,2839,76.7,stanford,3390
2014,31,Saint Mary's (CA),33,23,10,2531,76.7,saint mary's (ca),3388
2014,32,Pacific,31,18,13,2371,76.5,pacific,3334
2014,33,UTEP,37,29,8,2825,76.4,utep,3431
2014,34,Eastern Mich.,32,18,14,2438,76.2,eastern mich.,3185
2014,35,George Washington,34,23,11,2589,76.1,george washington,3203
2014,36,VCU,32,22,10,2426,75.8,vcu,3433
2014,37,Princeton,30,21,9,2271,75.7,princeton,3343
2014,38,Cal Poly,32,18,14,2420,75.6,cal poly,3142
2014,39,Nebraska,33,26,7,2494,75.6,nebraska,3304
2014,40,CSU Bakersfield,31,19,12,2333,75.3,cs bakersfield,3167
2014,41,South Dakota,33,19,14,2481,75.2,south dakota,3377
2014,42,Cleveland St.,30,14,16,2255,75.2,cleveland st.,3156
2014,43,NC State,33,25,8,2479,75.1,nc state,3301
2014,44,Penn St.,32,24,8,2403,75.1,penn st.,3336
2014,45,Gonzaga,34,29,5,2553,75.1,gonzaga,3211
2014,46,James Madison,35,29,6,2622,74.9,james madison,3241
2014,47,Florida,33,20,13,2472,74.9,florida,3196
2014,48,Purdue,31,22,9,2312,74.6,purdue,3345
2014,49,Iona,32,26,6,2380,74.4,iona,3233
2014,50,Southern Utah,33,23,10,2454,74.4,southern utah,3381
2014,51,Washington St.,34,17,17,2526,74.3,washington st.,3450
2014,52,Ill.-Chicago,35,26,9,2598,74.2,ill.-chicago,3227
2014,53,UMKC,30,11,19,2213,73.8,umkc,3282
2014,54,West Virginia,35,30,5,2581,73.7,west virginia,3452
2014,55,Quinnipiac,34,21,13,2494,73.4,quinnipiac,3346
2014,56,Michigan St.,33,23,10,2420,73.3,michigan st.,3277
2014,56,Marquette,33,22,11,2420,73.3,marquette,3266
2014,58,Wyoming,31,20,11,2270,73.2,wyoming,3461
2014,59,Arkansas St.,34,22,12,2487,73.1,arkansas st.,3117
2014,60,Western Ky.,33,24,9,2412,73.1,western ky.,3443
2014,61,Montana St.,30,15,15,2189,73,montana st.,3286
2014,62,Idaho,34,25,9,2479,72.9,idaho,3225
2014,63,South Carolina,34,29,5,2478,72.9,south carolina,3376
2014,64,Northern Ariz.,29,9,20,2111,72.8,northern ariz.,3319
2014,65,Southern U.,28,20,8,2037,72.8,southern u.,3380
2014,66,Iowa St.,31,20,11,2254,72.7,iowa st.,3235
2014,67,Murray St.,28,11,17,2033,72.6,murray st.,3293
2014,68,Syracuse,33,23,10,2396,72.6,syracuse,3393
2014,69,East Carolina,31,22,9,2249,72.5,east carolina,3187
2014,70,High Point,33,22,11,2394,72.5,high point,3219
2014,71,UC Irvine,32,17,15,2321,72.5,uc irvine,3414
2014,72,Washington,34,20,14,2462,72.4,washington,3449
2014,73,Marist,34,27,7,2460,72.4,marist,3265
2014,74,Seattle U,32,16,16,2310,72.2,seattle,3370
2014,75,Bryant,32,17,15,2309,72.2,bryant,3136
2014,76,Ole Miss,32,12,20,2308,72.1,ole miss,3279
2014,77,Colorado St.,33,25,8,2377,72,colorado st.,3161
2014,78,BYU,35,28,7,2519,72,byu,3140
2014,79,Coastal Caro.,31,15,16,2230,71.9,coastal caro.,3157
2014,80,Harvard,30,22,8,2155,71.8,harvard,3217
2014,81,Vanderbilt,31,18,13,2218,71.5,vanderbilt,3435
2014,82,Nevada,31,18,13,2216,71.5,nevada,3305
2014,83,Saint Joseph's,33,23,10,2358,71.5,saint joseph's,3386
2014,83,Albany (NY),33,28,5,2358,71.5,albany (ny),3107
2014,85,Loyola Marymount,30,9,21,2143,71.4,loyola marymount,3258
2014,86,New Mexico St.,31,11,20,2214,71.4,new mexico st.,3308
2014,87,Seton Hall,34,20,14,2419,71.1,seton hall,3371
2014,88,Wichita St.,33,26,7,2346,71.1,wichita st.,3455
2014,89,Drake,32,17,15,2273,71,drake,3179
2014,90,IUPUI,33,23,10,2342,71,iupui,3237
2014,91,Lamar University,31,18,13,2198,70.9,american university,3110
2014,92,Detroit Mercy,30,6,24,2127,70.9,detroit mercy,3178
2014,93,Mississippi St.,36,22,14,2551,70.9,mississippi st.,3280
2014,94,Florida A&M,31,17,14,2194,70.8,florida a&m,3197
2014,95,Hampton,33,28,5,2335,70.8,hampton,3214
2014,96,Oklahoma St.,34,25,9,2404,70.7,oklahoma st.,3329
2014,97,Texas Southern,33,20,13,2330,70.6,texas southern,3411
2014,98,Texas A&M,36,27,9,2541,70.6,texas a&m,3401
2014,99,Holy Cross,32,20,12,2255,70.5,holy cross,3221
2014,100,Oregon St.,35,24,11,2466,70.5,oregon st.,3333
2014,101,Oakland,30,13,17,2111,70.4,oakland,3324
2014,102,La.-Monroe,31,11,20,2180,70.3,la.-monroe,3419
2014,103,Virginia,31,14,17,2179,70.3,virginia,3438
2014,103,Youngstown St.,31,15,16,2179,70.3,youngstown st.,3464
2014,105,Boise St.,32,18,14,2249,70.3,boise st.,3129
2014,106,South Dakota St.,36,26,10,2527,70.2,south dakota st.,3355
2014,107,Fresno St.,33,22,11,2314,70.1,fresno st.,3201
2014,108,FGCU,34,26,8,2382,70.1,fgcu,3195
2014,109,Mt. St. Mary's,33,19,14,2310,70,mt. st. mary's,3291
2014,110,LSU,34,21,13,2379,70,lsu,3261
2014,111,Arizona St.,33,23,10,2304,69.8,arizona st.,3113
2014,112,Chattanooga,33,29,4,2302,69.8,chattanooga,3151
2014,113,California,32,22,10,2232,69.8,california,3143
2014,114,Liberty,31,20,11,2162,69.7,liberty,3251
2014,115,Austin Peay,29,9,20,2022,69.7,austin peay,3122
2014,116,Texas,34,22,12,2369,69.7,texas,3400
2014,116,Indiana,34,21,13,2369,69.7,indiana,3231
2014,118,Bradley,30,8,22,2090,69.7,bradley,3133
2014,119,Bowling Green,35,30,5,2438,69.7,bowling green,3132
2014,120,Miami (FL),31,16,15,2159,69.6,miami (fl),3274
2014,120,Missouri,31,17,14,2159,69.6,missouri,3281
2014,122,Long Beach St.,32,17,15,2228,69.6,long beach st.,3253
2014,123,Northwestern,33,17,16,2295,69.5,northwestern,3321
2014,124,Tulsa,28,12,16,1947,69.5,tulsa,3409
2014,125,Toledo,32,16,16,2224,69.5,toledo,3405
2014,126,Col. of Charleston,34,19,15,2360,69.4,col. of charleston,3158
2014,127,Davidson,32,16,16,2221,69.4,davidson,3172
2014,128,Tennessee St.,30,12,18,2082,69.4,tennessee st.,3398
2014,129,Grambling,31,11,20,2151,69.4,grambling,3212
2014,130,Eastern Wash.,30,16,14,2081,69.4,eastern wash.,3186
2014,130,Milwaukee,30,8,22,2081,69.4,milwaukee,3454
2014,130,Lipscomb,30,6,24,2081,69.4,lipscomb,3252
2014,133,Florida St.,33,21,12,2287,69.3,florida st.,3199
2014,134,North Dakota,32,22,10,2216,69.3,north dakota,3315
2014,135,San Diego,33,24,9,2284,69.2,san diego,3360
2014,136,Robert Morris,33,21,12,2283,69.2,robert morris,3352
2014,137,Colorado,34,19,15,2352,69.2,colorado,3160
2014,138,SFA,36,23,13,2490,69.2,utsa,3427
2014,138,Providence,30,7,23,2075,69.2,providence,3344
2014,140,Michigan,34,20,14,2351,69.1,michigan,3276
2014,141,FIU,33,15,18,2281,69.1,fiu,3198
2014,142,San Francisco,31,12,19,2142,69.1,san francisco,3362
2014,143,Denver,32,9,23,2208,69,denver,3176
2014,144,George Mason,31,8,23,2138,69,george mason,3206
2014,145,Sacred Heart,30,12,18,2068,68.9,sacred heart,3357
2014,146,Eastern Ky.,30,17,13,2066,68.9,eastern ky.,3184
2014,147,Montana,34,23,11,2341,68.9,montana,3285
2014,148,Lehigh,31,13,18,2134,68.8,lehigh,3250
2014,149,Minnesota,35,22,13,2406,68.7,minnesota,3278
2014,150,Tulane,31,20,11,2128,68.6,tulane,3408
2014,151,Winthrop,33,24,9,2258,68.4,winthrop,3457
2014,152,Green Bay,32,22,10,2189,68.4,green bay,3453
2014,153,Charlotte,31,15,16,2118,68.3,charlotte,3150
2014,154,Weber St.,29,7,22,1981,68.3,weber st.,3451
2014,155,UNI,30,17,13,2048,68.3,uni,3320
2014,155,Portland,30,14,16,2048,68.3,portland,3339
2014,157,Nicholls St.,31,17,14,2116,68.3,nicholls st.,3311
2014,158,Tennessee Tech,30,12,18,2047,68.2,tennessee tech,3399
2014,159,CSUN,33,18,15,2251,68.2,lsu,3261
2014,160,Old Dominion,34,18,16,2319,68.2,old dominion,3330
2014,161,Buffalo,30,17,13,2046,68.2,buffalo,3138
2014,162,SMU,32,18,14,2182,68.2,smu,3374
2014,163,Duquesne,33,20,13,2249,68.2,duquesne,3182
2014,164,Houston Baptist,29,12,17,1974,68.1,houston baptist,3223
2014,165,Ball St.,35,18,17,2379,68,ball st.,3123
2014,166,Navy,32,24,8,2173,67.9,navy,3298
2014,167,North Dakota St.,30,6,24,2036,67.9,north dakota st.,3295
2014,168,Wake Forest,31,15,16,2103,67.8,wake forest,3448
2014,169,Illinois,30,9,21,2035,67.8,illinois,3228
2014,170,Southeastern La.,30,8,22,2034,67.8,southeastern la.,3368
2014,171,UAB,31,16,15,2101,67.8,uab,3412
2014,172,McNeese,33,19,14,2229,67.5,mcneese st,3270
2014,173,UC Riverside,29,6,23,1956,67.4,uc riverside,3415
2014,174,A&M-Corpus Christi,30,18,12,2020,67.3,a&m-corpus chris,3394
2014,175,Missouri St.,31,14,17,2086,67.3,missouri st.,3283
2014,176,Georgia St.,31,12,19,2082,67.2,georgia st.,3209
2014,177,Southern California,35,22,13,2350,67.1,southern california,3425
2014,178,South Fla.,36,23,13,2412,67,south fla.,3378
2014,178,Furman,31,18,13,2077,67,furman,3202
2014,180,UC Davis,31,15,16,2076,67,uc davis,3413
2014,181,USC Upstate,32,17,15,2142,66.9,usc upstate,3367
2014,182,Western Mich.,31,13,18,2074,66.9,western mich.,3444
2014,183,Santa Clara,30,10,20,2007,66.9,santa clara,3365
2014,184,Fordham,33,25,8,2207,66.9,fordham,3200
2014,185,Bucknell,30,16,14,2005,66.8,bucknell,3137
2014,186,Evansville,31,15,16,2070,66.8,evansville,3191
2014,187,St. Francis Brooklyn,30,19,11,2002,66.7,st. francis brooklyn,3383
2014,188,UNLV,32,13,19,2135,66.7,unlv,3424
2014,189,Kansas,32,13,19,2134,66.7,kansas,3242
2014,190,Middle Tenn.,34,29,5,2267,66.7,middle tenn.,3292
2014,191,Arkansas,30,19,11,1997,66.6,arkansas,3116
2014,192,Army West Point,33,25,8,2196,66.5,armstrong,3118
2014,193,Ohio St.,35,17,18,2325,66.4,ohio st.,3326
2014,194,Utah Valley,30,7,23,1989,66.3,utah valley,3430
2014,195,St. John's (NY),34,23,11,2254,66.3,st. john's (ny),3385
2014,196,Rutgers,37,28,9,2450,66.2,rutgers,3353
2014,197,N.C. A&T,31,24,7,2052,66.2,n.c. a&t,3299
2014,198,Savannah St.,33,19,14,2184,66.2,savannah st.,3366
2014,199,Georgia,32,20,12,2114,66.1,georgia,3208
2014,200,Boston College,31,12,19,2045,66,boston college,3130
2014,201,Auburn,34,19,15,2239,65.9,auburn,3120
2014,202,Alabama A&M,30,6,24,1975,65.8,alabama a&m,3105
2014,203,Georgetown,32,11,21,2103,65.7,georgetown,3207
2014,204,Coppin St.,31,17,14,2035,65.6,coppin st.,3164
2014,205,Yale,28,13,15,1836,65.6,yale,3463
2014,206,Creighton,34,20,14,2227,65.5,creighton,3166
2014,207,Wisconsin,29,10,19,1899,65.5,wisconsin,3458
2014,208,ETSU,30,9,21,1964,65.5,etsu,3190
2014,209,Stony Brook,33,24,9,2154,65.3,stony brook,3392
2014,210,SIUE,30,11,19,1955,65.2,siena,3373
2014,211,Maine,32,17,15,2085,65.2,maine,3263
2014,212,Jackson St.,30,15,15,1951,65,jackson st.,3238
2014,212,Gardner-Webb,30,16,14,1951,65,gardner-webb,3205
2014,214,Indiana St.,32,20,12,2081,65,indiana st.,3232
2014,215,Penn,29,22,7,1885,65,penn,3335
2014,216,Villanova,32,23,9,2078,64.9,villanova,3437
2014,217,Niagara,30,10,20,1948,64.9,niagara,3310
2014,218,Portland St.,29,8,21,1883,64.9,portland st.,3340
2014,219,Valparaiso,31,6,25,2012,64.9,valparaiso,3434
2014,220,Miami (OH),30,8,22,1947,64.9,miami (oh),3275
2014,221,Elon,31,15,16,2009,64.8,elon,3189
2014,222,Alabama,30,14,16,1944,64.8,alabama,3104
2014,223,Butler,31,15,16,2007,64.7,butler,3139
2014,224,Virginia Tech,30,14,16,1940,64.7,virginia tech,3439
2014,225,Prairie View,32,14,18,2069,64.7,prairie view,3341
2014,226,Sam Houston St.,29,13,16,1873,64.6,sam houston st.,3358
2014,226,Morehead St.,29,12,17,1873,64.6,morehead st.,3287
2014,228,Temple,30,14,16,1937,64.6,temple,3396
2014,229,Louisiana Tech,32,12,20,2066,64.6,louisiana tech,3256
2014,230,Delaware St.,29,8,21,1869,64.4,delaware st.,3175
2014,231,UTRGV,30,14,16,1933,64.4,utrgv,3410
2014,232,Pepperdine,31,6,25,1997,64.4,pepperdine,3337
2014,233,Campbell,31,19,12,1996,64.4,campbell,3144
2014,234,North Texas,30,12,18,1931,64.4,north texas,3317
2014,235,Wagner,30,9,21,1930,64.3,wagner,3447
2014,236,Louisiana,30,14,16,1929,64.3,se louisiana,3368
2014,237,UC Santa Barbara,30,8,22,1927,64.2,uc santa barbara,3364
2014,238,Belmont,32,14,18,2054,64.2,belmont,3125
2014,239,Lafayette,30,14,16,1925,64.2,lafayette,3248
2014,240,American,32,22,10,2052,64.1,american,3110
2014,241,Mercer,31,17,14,1986,64.1,mercer,3273
2014,241,Hawaii,31,17,14,1986,64.1,hawaii,3218
2014,243,Texas St.,32,16,16,2050,64.1,texas st.,3402
2014,244,Oral Roberts,29,9,20,1857,64,oral roberts,3331
2014,245,Richmond,30,14,16,1921,64,richmond,3350
2014,246,Idaho St.,31,14,17,1984,64,idaho st.,3226
2014,247,Delaware,31,20,11,1983,64,delaware,3174
2014,248,Alabama St.,30,16,14,1918,63.9,alabama st.,3106
2014,249,San Diego St.,30,13,17,1917,63.9,san diego st.,3361
2014,250,Hofstra,29,14,15,1852,63.9,hofstra,3220
2014,251,Northeastern,30,12,18,1915,63.8,northeastern,3318
2014,252,Rider,32,15,17,2040,63.8,rider,3351
2014,253,UCLA,31,13,18,1976,63.7,ucla,3417
2014,254,Northwestern St.,34,21,13,2166,63.7,northwestern st.,3322
2014,255,Jacksonville,30,13,17,1911,63.7,jacksonville,3239
2014,256,Jacksonville St.,32,14,18,2035,63.6,jacksonville st.,3240
2014,257,UMES,30,9,21,1906,63.5,umes,3271
2014,258,UNCG,30,7,23,1905,63.5,unc,3314
2014,259,Memphis,31,13,18,1968,63.5,memphis,3272
2014,260,Southeast Mo. St.,29,10,19,1840,63.4,southeast mo. st.,3369
2014,261,New Mexico,30,11,19,1901,63.4,new mexico,3307
2014,262,Marshall,31,11,20,1963,63.3,marshall,3267
2014,263,Brown,28,10,18,1771,63.3,brown,3135
2014,263,Central Conn. St.,28,11,17,1771,63.3,central conn. st.,3148
2014,265,Appalachian St.,29,13,16,1834,63.2,appalachian st.,3111
2014,266,TCU,33,18,15,2085,63.2,tcu,3395
2014,267,Cornell,28,14,14,1768,63.1,cornell,3165
2014,268,Northern Colo.,29,14,15,1829,63.1,northern colo.,3294
2014,269,Charleston So.,30,8,22,1891,63,charleston so.,3149
2014,270,Pittsburgh,31,11,20,1945,62.7,pittsburgh,3338
2014,271,Eastern Ill.,28,12,16,1756,62.7,eastern ill.,3183
2014,272,St. Bonaventure,35,24,11,2183,62.4,st. bonaventure,3382
2014,273,Rice,30,13,17,1871,62.4,rice,3349
2014,274,Ga. Southern,31,10,21,1933,62.4,ga. southern,3204
2014,275,Massachusetts,31,4,27,1932,62.3,massachusetts,3269
2014,276,Ohio,30,9,21,1867,62.2,ohio,3325
2014,277,Kansas St.,30,11,19,1865,62.2,kansas st.,3243
2014,278,Saint Louis,30,12,18,1863,62.1,saint louis,3387
2014,279,UTSA,31,14,17,1922,62,utsa,3427
2014,280,Vermont,30,7,23,1859,62,vermont,3436
2014,281,William & Mary,29,8,21,1794,61.9,william & mary,3456
2014,282,Norfolk St.,28,12,16,1732,61.9,norfolk st.,3313
2014,283,Cal St. Fullerton,30,12,18,1855,61.8,cal st. fullerton,3168
2014,283,Colgate,30,8,22,1855,61.8,colgate,3159
2014,285,Fairfield,33,22,11,2039,61.8,fairfield,3193
2014,286,Central Ark.,30,18,12,1853,61.8,central ark.,3146
2014,287,Northern Ill.,30,11,19,1852,61.7,northern ill.,3296
2014,288,Siena,31,9,22,1908,61.5,siena,3373
2014,289,New Hampshire,31,19,12,1904,61.4,new hampshire,3306
2014,290,Western Caro.,32,15,17,1965,61.4,western caro.,3441
2014,291,Mississippi Val.,30,9,21,1838,61.3,mississippi val.,3290
2014,292,Illinois St.,30,10,20,1836,61.2,illinois st.,3229
2014,293,UT Arlington,29,4,25,1773,61.1,ut arlington,3426
2014,294,Loyola Chicago,32,11,21,1951,61,loyola chicago,3260
2014,295,UNC Asheville,31,11,20,1888,60.9,unc asheville,3421
2014,296,South Ala.,28,8,20,1699,60.7,south ala.,3375
2014,297,Little Rock,30,18,12,1819,60.6,little rock,3114
2014,298,Howard,31,11,20,1873,60.4,howard,3224
2014,299,Kennesaw St.,30,6,24,1804,60.1,kennesaw st.,3244
2014,300,Fairleigh Dickinson,29,3,26,1743,60.1,fairleigh dickinson,3192
2014,301,Columbia,28,6,22,1681,60,columbia,3162
2014,302,Manhattan,30,9,21,1790,59.7,manhattan,3264
2014,303,LIU Brooklyn,30,9,21,1789,59.6,liu brooklyn,3254
2014,304,Boston U.,33,13,20,1967,59.6,boston u.,3131
2014,305,Utah,31,12,19,1846,59.5,utah,3428
2014,306,Drexel,31,15,16,1843,59.5,drexel,3180
2014,307,Towson,30,13,17,1776,59.2,towson,3406
2014,308,Xavier,31,8,23,1835,59.2,xavier,3462
2014,309,Clemson,32,13,19,1888,59,clemson,3155
2014,310,Hartford,31,13,18,1825,58.9,hartford,3216
2014,311,Wofford,29,6,23,1703,58.7,wofford,3459
2014,312,Bethune-Cookman,30,12,18,1757,58.6,bethune-cookman,3126
2014,313,Canisius,30,13,17,1748,58.3,canisius,3145
2014,314,Ark.-Pine Bluff,29,3,26,1687,58.2,ark.-pine bluff,3115
2014,315,Texas Tech,30,6,24,1742,58.1,texas tech,3403
2014,316,Arizona,30,5,25,1736,57.9,arizona,3112
2014,316,La Salle,30,15,15,1736,57.9,la salle,3247
2014,318,NJIT,29,8,21,1677,57.8,njit,3312
2014,319,South Carolina St.,27,7,20,1549,57.4,south carolina st.,3354
2014,320,Monmouth,33,8,25,1893,57.4,monmouth,3284
2014,321,UCF,30,10,20,1718,57.3,ucf,3416
2014,322,Morgan St.,30,5,25,1710,57,morgan st.,3288
2014,323,Longwood,30,8,22,1696,56.5,longwood,3255
2014,324,Southern Ill.,30,5,25,1694,56.5,southern ill.,3356
2014,325,N.C. Central,30,11,19,1685,56.2,n.c. central,3300
2014,326,Dartmouth,28,5,23,1569,56,dartmouth,3171
2014,327,North Florida,29,6,23,1615,55.7,north florida,3316
2014,328,Radford,30,7,23,1669,55.6,radford,3347
2014,329,Kent St.,30,7,23,1651,55,kent st.,3245
2014,330,Rhode Island,30,7,23,1641,54.7,rhode island,3348
2014,331,Samford,30,10,20,1633,54.4,samford,3359
2014,332,Chicago St.,30,3,27,1624,54.1,chicago st.,3152
2014,333,Houston,31,6,25,1669,53.8,houston,3222
2014,334,Air Force,29,1,28,1555,53.6,air force,3102
2014,335,UNCW,32,5,27,1705,53.3,unc,3314
2014,336,Loyola Maryland,30,5,25,1596,53.2,loyola maryland,3259
2014,337,Cincinnati,31,13,18,1648,53.2,cincinnati,3153
2014,338,Alcorn,30,8,22,1591,53,alcorn,3108
2014,339,Presbyterian,31,12,19,1623,52.4,presbyterian,3342
2014,340,UMBC,29,4,25,1477,50.9,umbc,3420
2014,341,Binghamton,30,5,25,1487,49.6,binghamton,3127
2014,342,Saint Peter's,30,3,27,1485,49.5,saint peter's,3389
2014,343,New Orleans,29,0,29,1391,48,new orleans,3309
2015,1,UConn,39,38,1,3481,89.3,uconn,3163
2015,2,DePaul,35,27,8,3010,86,depaul,3177
2015,3,Sacramento St.,34,18,16,2911,85.6,sacramento st.,3170
2015,4,Ohio St.,35,24,11,2836,81,ohio st.,3326
2015,5,Notre Dame,39,36,3,3114,79.8,notre dame,3323
2015,6,Iowa,34,26,8,2703,79.5,iowa,3234
2015,7,Baylor,37,33,4,2941,79.5,baylor,3124
2015,8,Wright St.,34,25,9,2679,78.8,wright st.,3460
2015,9,Maryland,37,34,3,2908,78.6,maryland,3268
2015,10,Quinnipiac,35,31,4,2749,78.5,quinnipiac,3346
2015,11,San Jose St.,32,15,17,2511,78.5,san jose st.,3363
2015,12,South Dakota,34,26,8,2626,77.2,south dakota,3377
2015,13,Dayton,35,28,7,2678,76.5,dayton,3173
2015,14,Drake,31,20,11,2362,76.2,drake,3179
2015,15,Minnesota,33,23,10,2514,76.2,minnesota,3278
2015,16,Troy,31,20,11,2361,76.2,troy,3407
2015,17,James Madison,33,29,4,2505,75.9,james madison,3241
2015,18,South Carolina,37,34,3,2807,75.9,south carolina,3376
2015,19,Princeton,32,31,1,2424,75.8,princeton,3343
2015,20,Western Ky.,35,30,5,2647,75.6,western ky.,3443
2015,21,Kentucky,34,24,10,2571,75.6,kentucky,3246
2015,22,Seton Hall,34,28,6,2569,75.6,seton hall,3371
2015,23,Florida St.,37,32,5,2795,75.5,florida st.,3199
2015,24,North Carolina,35,26,9,2637,75.3,north carolina,3314
2015,25,Washington,33,23,10,2476,75,washington,3449
2015,26,Oklahoma,33,21,12,2465,74.7,oklahoma,3328
2015,27,Akron,31,22,9,2307,74.4,akron,3103
2015,28,Murray St.,29,8,21,2134,73.6,murray st.,3293
2015,29,CSU Bakersfield,32,23,9,2346,73.3,cs bakersfield,3167
2015,30,Louisville,34,27,7,2486,73.1,louisville,3257
2015,30,Mississippi St.,34,27,7,2486,73.1,mississippi st.,3280
2015,32,George Washington,33,29,4,2411,73.1,george washington,3203
2015,33,Oregon St.,32,27,5,2331,72.8,oregon st.,3333
2015,34,UT Martin,33,22,11,2395,72.6,ut martin,3404
2015,35,Western Ill.,30,17,13,2173,72.4,western ill.,3442
2015,36,South Dakota St.,33,24,9,2382,72.2,south dakota st.,3355
2015,37,Middle Tenn.,34,24,10,2454,72.2,middle tenn.,3292
2015,38,New Mexico St.,30,22,8,2159,72,new mexico st.,3308
2015,39,FGCU,34,31,3,2446,71.9,fgcu,3195
2015,40,Indiana,31,15,16,2229,71.9,indiana,3231
2015,41,Georgia Tech,34,19,15,2442,71.8,georgia tech,3210
2015,42,Northwestern,32,23,9,2297,71.8,northwestern,3321
2015,43,Stetson,31,23,8,2224,71.7,stetson,3391
2015,44,Gonzaga,34,26,8,2439,71.7,gonzaga,3211
2015,45,Lamar University,30,17,13,2151,71.7,american university,3110
2015,46,South Fla.,35,27,8,2496,71.3,south fla.,3378
2015,47,Tennessee,36,30,6,2567,71.3,tennessee,3397
2015,48,Arkansas St.,35,24,11,2485,71,arkansas st.,3117
2015,49,Pacific,31,21,10,2196,70.8,pacific,3334
2015,50,Boise St.,33,22,11,2331,70.6,boise st.,3129
2015,51,Bryant,31,22,9,2189,70.6,bryant,3136
2015,52,North Dakota,32,17,15,2258,70.6,north dakota,3315
2015,53,Austin Peay,30,10,20,2110,70.3,austin peay,3122
2015,53,UNLV,30,13,17,2110,70.3,unlv,3424
2015,55,Cleveland St.,32,19,13,2248,70.3,cleveland st.,3156
2015,56,UC Riverside,31,17,14,2176,70.2,uc riverside,3415
2015,57,Morehead St.,30,12,18,2104,70.1,morehead st.,3287
2015,58,Louisiana Tech,31,16,15,2174,70.1,louisiana tech,3256
2015,59,SFA,31,23,8,2173,70.1,utsa,3427
2015,60,San Francisco,33,19,14,2308,69.9,san francisco,3362
2015,61,Michigan,35,20,15,2446,69.9,michigan,3276
2015,62,California,34,24,10,2373,69.8,california,3143
2015,63,Ohio,32,27,5,2233,69.8,ohio,3325
2015,64,SIUE,31,19,12,2160,69.7,siena,3373
2015,65,Fort Wayne,30,9,21,2089,69.6,iupu-fort wayne,3236
2015,66,Duke,34,23,11,2367,69.6,duke,3181
2015,67,TCU,32,18,14,2227,69.6,tcu,3395
2015,68,Syracuse,32,22,10,2224,69.5,syracuse,3393
2015,69,McNeese,32,18,14,2221,69.4,mcneese st,3270
2015,70,Iowa St.,31,18,13,2151,69.4,iowa st.,3235
2015,71,Stanford,36,26,10,2494,69.3,stanford,3390
2015,72,High Point,32,20,12,2216,69.3,high point,3219
2015,73,Sacred Heart,29,16,13,2008,69.2,sacred heart,3357
2015,74,Green Bay,33,28,5,2284,69.2,green bay,3453
2015,75,Saint Francis (PA),29,6,23,2006,69.2,saint francis (pa),3384
2015,76,Eastern Wash.,33,21,12,2282,69.2,eastern wash.,3186
2015,77,Colorado,32,15,17,2212,69.1,colorado,3160
2015,78,Iona,30,15,15,2071,69,iona,3233
2015,79,Duquesne,34,23,11,2347,69,duquesne,3182
2015,80,Coastal Caro.,30,12,18,2069,69,coastal caro.,3157
2015,81,Youngstown St.,32,21,11,2206,68.9,youngstown st.,3464
2015,82,Eastern Mich.,37,24,13,2549,68.9,eastern mich.,3185
2015,83,Albany (NY),33,24,9,2273,68.9,albany (ny),3107
2015,84,Idaho,29,14,15,1994,68.8,idaho,3225
2015,85,Lehigh,31,19,12,2131,68.7,lehigh,3250
2015,86,Creighton,31,17,14,2130,68.7,creighton,3166
2015,87,Rutgers,33,23,10,2266,68.7,rutgers,3353
2015,88,Hawaii,32,23,9,2191,68.5,hawaii,3218
2015,89,Fla. Atlantic,30,13,17,2052,68.4,fla. atlantic,3194
2015,89,Oakland,30,12,18,2052,68.4,oakland,3324
2015,91,Southern Miss.,36,25,11,2460,68.3,southern miss.,3379
2015,92,North Dakota St.,29,11,18,1979,68.2,north dakota st.,3295
2015,93,Furman,33,19,14,2249,68.2,furman,3202
2015,94,BYU,33,23,10,2248,68.1,byu,3140
2015,95,Wyoming,30,16,14,2043,68.1,wyoming,3461
2015,96,ETSU,33,21,12,2246,68.1,etsu,3190
2015,97,Washington St.,32,17,15,2177,68,washington st.,3450
2015,98,Michigan St.,31,16,15,2108,68,michigan st.,3277
2015,99,Southern California,30,15,15,2039,68,southern california,3425
2015,100,Montana St.,30,15,15,2036,67.9,montana st.,3286
2015,101,George Mason,30,13,17,2035,67.8,george mason,3206
2015,102,Texas,35,24,11,2371,67.7,texas,3400
2015,103,Arizona St.,35,29,6,2370,67.7,arizona st.,3113
2015,104,Appalachian St.,30,14,16,2030,67.7,appalachian st.,3111
2015,105,Missouri St.,33,18,15,2228,67.5,missouri st.,3283
2015,106,Miami (FL),33,20,13,2227,67.5,miami (fl),3274
2015,107,Long Beach St.,32,22,10,2157,67.4,long beach st.,3253
2015,108,Marquette,31,9,22,2088,67.4,marquette,3266
2015,109,Virginia,31,17,14,2087,67.3,virginia,3438
2015,110,NC State,33,18,15,2221,67.3,nc state,3301
2015,111,Cal Poly,29,15,14,1951,67.3,cal poly,3142
2015,112,Liberty,33,26,7,2217,67.2,liberty,3251
2015,112,CSUN,33,23,10,2217,67.2,lsu,3261
2015,114,Nebraska,32,21,11,2148,67.1,nebraska,3304
2015,115,Georgia St.,30,13,17,2012,67.1,georgia st.,3209
2015,116,Wake Forest,33,13,20,2211,67,wake forest,3448
2015,117,IUPUI,31,15,16,2075,66.9,iupui,3237
2015,118,Saint Mary's (CA),34,23,11,2275,66.9,saint mary's (ca),3388
2015,119,Tennessee St.,31,18,13,2073,66.9,tennessee st.,3398
2015,119,Illinois,31,15,16,2073,66.9,illinois,3228
2015,121,San Diego,32,25,7,2137,66.8,san diego,3360
2015,122,Mercer,35,20,15,2337,66.8,mercer,3273
2015,123,Texas A&M,33,23,10,2200,66.7,texas a&m,3401
2015,124,East Carolina,33,22,11,2199,66.6,east carolina,3187
2015,125,Robert Morris,32,17,15,2131,66.6,robert morris,3352
2015,126,Charlotte,32,15,17,2126,66.4,charlotte,3150
2015,127,Fairleigh Dickinson,30,10,20,1991,66.4,fairleigh dickinson,3192
2015,128,Temple,37,20,17,2455,66.4,temple,3396
2015,129,Houston Baptist,33,15,18,2189,66.3,houston baptist,3223
2015,130,Texas Southern,29,19,10,1923,66.3,texas southern,3411
2015,131,Tulsa,32,18,14,2120,66.3,tulsa,3409
2015,132,Southern Ill.,30,17,13,1985,66.2,southern ill.,3356
2015,133,Colorado St.,31,23,8,2051,66.2,colorado st.,3161
2015,134,UCLA,37,19,18,2446,66.1,ucla,3417
2015,135,Marshall,32,17,15,2115,66.1,marshall,3267
2015,136,Milwaukee,30,10,20,1981,66,milwaukee,3454
2015,137,Pittsburgh,32,20,12,2113,66,pittsburgh,3338
2015,138,Northern Colo.,35,22,13,2307,65.9,northern colo.,3294
2015,139,Elon,32,19,13,2109,65.9,elon,3189
2015,140,Central Mich.,31,13,18,2038,65.7,central mich.,3141
2015,141,Saint Louis,31,15,16,2037,65.7,saint louis,3387
2015,142,Toledo,33,19,14,2168,65.7,toledo,3405
2015,143,Santa Clara,29,11,18,1905,65.7,santa clara,3365
2015,144,UTEP,28,12,16,1839,65.7,utep,3431
2015,145,West Virginia,38,23,15,2494,65.6,west virginia,3452
2015,146,Southern U.,30,19,11,1965,65.5,southern u.,3380
2015,146,UNCW,30,14,16,1965,65.5,unc,3314
2015,148,Brown,28,10,18,1833,65.5,brown,3135
2015,149,Loyola Marymount,31,7,24,2026,65.4,loyola marymount,3258
2015,150,Boston College,30,13,17,1960,65.3,boston college,3130
2015,151,Oregon,30,13,17,1959,65.3,oregon,3332
2015,152,Harvard,28,14,14,1824,65.1,harvard,3217
2015,153,Ole Miss,33,19,14,2149,65.1,ole miss,3279
2015,154,Southern Utah,28,13,15,1823,65.1,southern utah,3381
2015,155,Little Rock,34,29,5,2212,65.1,little rock,3114
2015,156,Jacksonville St.,29,19,10,1884,65,jacksonville st.,3240
2015,157,UC Davis,31,15,16,2010,64.8,uc davis,3413
2015,158,Montana,33,24,9,2132,64.6,montana,3285
2015,159,Detroit Mercy,30,12,18,1936,64.5,detroit mercy,3178
2015,160,Wichita St.,34,29,5,2191,64.4,wichita st.,3455
2015,161,Ball St.,31,17,14,1997,64.4,ball st.,3123
2015,162,Wisconsin,29,9,20,1868,64.4,wisconsin,3458
2015,163,Gardner-Webb,32,15,17,2061,64.4,gardner-webb,3205
2015,164,Tennessee Tech,29,6,23,1866,64.3,tennessee tech,3399
2015,165,Buffalo,32,19,13,2059,64.3,buffalo,3138
2015,165,Oklahoma St.,32,20,12,2059,64.3,oklahoma st.,3329
2015,167,Lipscomb,29,8,21,1865,64.3,lipscomb,3252
2015,168,LIU Brooklyn,30,9,21,1927,64.2,liu brooklyn,3254
2015,169,Winthrop,30,17,13,1925,64.2,winthrop,3457
2015,170,UTRGV,34,19,15,2181,64.1,utrgv,3410
2015,171,Fresno St.,33,23,10,2116,64.1,fresno st.,3201
2015,172,USC Upstate,30,14,16,1921,64,usc upstate,3367
2015,173,Utah St.,31,8,23,1985,64,utah st.,3429
2015,174,Tulane,33,22,11,2111,64,tulane,3408
2015,175,Valparaiso,30,6,24,1919,64,valparaiso,3434
2015,176,Idaho St.,30,13,17,1918,63.9,idaho st.,3226
2015,177,Nicholls St.,30,17,13,1913,63.8,nicholls st.,3311
2015,178,Southeastern La.,29,7,22,1848,63.7,southeastern la.,3368
2015,179,Portland,30,4,26,1911,63.7,portland,3339
2015,179,Norfolk St.,30,14,16,1911,63.7,norfolk st.,3313
2015,181,Ill.-Chicago,30,16,14,1909,63.6,ill.-chicago,3227
2015,182,UNI,32,17,15,2036,63.6,uni,3320
2015,183,Jackson St.,31,14,17,1971,63.6,jackson st.,3238
2015,184,Savannah St.,32,21,11,2034,63.6,savannah st.,3366
2015,185,UNCG,30,6,24,1905,63.5,unc,3314
2015,186,American,33,24,9,2094,63.5,american,3110
2015,187,Kennesaw St.,30,17,13,1903,63.4,kennesaw st.,3244
2015,188,Missouri,33,19,14,2092,63.4,missouri,3281
2015,189,Oral Roberts,34,18,16,2155,63.4,oral roberts,3331
2015,190,Central Conn. St.,32,19,13,2028,63.4,central conn. st.,3148
2015,191,Marist,33,21,12,2091,63.4,marist,3265
2015,192,Monmouth,31,13,18,1963,63.3,monmouth,3284
2015,193,Hampton,32,19,13,2026,63.3,hampton,3214
2015,194,Kansas,32,15,17,2025,63.3,kansas,3242
2015,195,Butler,30,14,16,1898,63.3,butler,3139
2015,196,LSU,31,17,14,1961,63.3,lsu,3261
2015,197,Pepperdine,30,8,22,1897,63.2,pepperdine,3337
2015,198,Purdue,31,11,20,1959,63.2,purdue,3345
2015,199,Georgetown,31,4,27,1958,63.2,georgetown,3207
2015,200,Xavier,33,18,15,2083,63.1,xavier,3462
2015,201,St. John's (NY),34,23,11,2145,63.1,st. john's (ny),3385
2015,202,Richmond,33,19,14,2081,63.1,richmond,3350
2015,203,William & Mary,31,15,16,1949,62.9,william & mary,3456
2015,204,UCF,30,9,21,1886,62.9,ucf,3416
2015,204,Penn St.,30,6,24,1886,62.9,penn st.,3336
2015,206,Evansville,32,13,19,2010,62.8,evansville,3191
2015,207,Old Dominion,34,21,13,2133,62.7,old dominion,3330
2015,208,Belmont,31,14,17,1944,62.7,belmont,3125
2015,208,Niagara,31,14,17,1944,62.7,niagara,3310
2015,210,Chattanooga,33,29,4,2067,62.6,chattanooga,3151
2015,211,Wagner,29,7,22,1810,62.4,wagner,3447
2015,212,Louisiana,35,23,12,2183,62.4,se louisiana,3368
2015,213,Northern Ariz.,30,13,17,1868,62.3,northern ariz.,3319
2015,214,VCU,30,16,14,1867,62.2,vcu,3433
2015,215,Eastern Ky.,26,9,17,1618,62.2,eastern ky.,3184
2015,216,Texas St.,32,17,15,1991,62.2,texas st.,3402
2015,216,Prairie View,32,14,18,1991,62.2,prairie view,3341
2015,218,Villanova,36,22,14,2238,62.2,villanova,3437
2015,219,Holy Cross,32,15,17,1987,62.1,holy cross,3221
2015,220,Hofstra,33,20,13,2047,62,hofstra,3220
2015,221,La Salle,31,15,16,1922,62,la salle,3247
2015,222,Florida,30,13,17,1858,61.9,florida,3196
2015,222,Rice,30,9,21,1858,61.9,rice,3349
2015,224,Western Caro.,30,11,19,1853,61.8,western caro.,3441
2015,225,Siena,35,22,13,2161,61.7,siena,3373
2015,226,Utah Valley,30,11,19,1850,61.7,utah valley,3430
2015,227,Delaware,32,15,17,1973,61.7,delaware,3174
2015,228,Vanderbilt,31,15,16,1911,61.6,vanderbilt,3435
2015,229,Saint Joseph's,30,13,17,1848,61.6,saint joseph's,3386
2015,230,Western Mich.,33,20,13,2030,61.5,western mich.,3444
2015,231,Canisius,30,10,20,1845,61.5,canisius,3145
2015,231,Indiana St.,30,17,13,1845,61.5,indiana st.,3232
2015,233,Columbia,28,8,20,1720,61.4,columbia,3162
2015,234,Campbell,31,19,12,1904,61.4,campbell,3144
2015,235,New Mexico,34,21,13,2087,61.4,new mexico,3307
2015,236,UAB,31,18,13,1901,61.3,uab,3412
2015,237,Alabama St.,32,17,15,1962,61.3,alabama st.,3106
2015,238,Delaware St.,30,5,25,1837,61.2,delaware st.,3175
2015,239,South Carolina St.,28,16,12,1714,61.2,south carolina st.,3354
2015,240,Jacksonville,29,12,17,1774,61.2,jacksonville,3239
2015,241,UMES,31,14,17,1896,61.2,umes,3271
2015,242,Bucknell,30,18,12,1832,61.1,bucknell,3137
2015,243,Maine,32,23,9,1954,61.1,maine,3263
2015,244,UMBC,31,12,19,1890,61,umbc,3420
2015,245,La.-Monroe,29,12,17,1768,61,la.-monroe,3419
2015,246,N.C. A&T,31,20,11,1887,60.9,n.c. a&t,3299
2015,247,A&M-Corpus Christi,30,16,14,1823,60.8,a&m-corpus chris,3394
2015,247,Massachusetts,30,12,18,1823,60.8,massachusetts,3269
2015,249,New Hampshire,29,17,12,1762,60.8,new hampshire,3306
2015,250,Denver,31,8,23,1883,60.7,denver,3176
2015,251,Northwestern St.,34,19,15,2064,60.7,northwestern st.,3322
2015,252,Seattle U,31,10,21,1879,60.6,seattle,3370
2015,253,Howard,31,4,27,1878,60.6,howard,3224
2015,254,Providence,30,6,24,1817,60.6,providence,3344
2015,255,Southeast Mo. St.,29,10,19,1755,60.5,southeast mo. st.,3369
2015,256,Penn,30,21,9,1815,60.5,penn,3335
2015,257,Ga. Southern,29,5,24,1754,60.5,ga. southern,3204
2015,258,Northeastern,29,4,25,1751,60.4,northeastern,3318
2015,259,Army West Point,31,23,8,1870,60.3,armstrong,3118
2015,260,Stony Brook,31,17,14,1868,60.3,stony brook,3392
2015,261,Sam Houston St.,28,6,22,1680,60,sam houston st.,3358
2015,262,UTSA,31,16,15,1857,59.9,utsa,3427
2015,263,UNC Asheville,31,9,22,1856,59.9,unc asheville,3421
2015,264,Alabama A&M,30,6,24,1794,59.8,alabama a&m,3105
2015,265,Arkansas,32,18,14,1910,59.7,arkansas,3116
2015,265,Cal St. Fullerton,32,13,19,1910,59.7,cal st. fullerton,3168
2015,267,Alabama,32,13,19,1909,59.7,alabama,3104
2015,268,Kansas St.,33,19,14,1967,59.6,kansas st.,3243
2015,269,St. Bonaventure,30,15,15,1787,59.6,st. bonaventure,3382
2015,270,St. Francis Brooklyn,34,15,19,2023,59.5,st. francis brooklyn,3383
2015,271,Samford,30,15,15,1782,59.4,samford,3359
2015,272,Weber St.,29,11,18,1719,59.3,weber st.,3451
2015,273,Fordham,33,21,12,1956,59.3,fordham,3200
2015,274,Eastern Ill.,30,10,20,1778,59.3,eastern ill.,3183
2015,275,UT Arlington,30,17,13,1770,59,ut arlington,3426
2015,275,Vermont,29,5,24,1711,59,vermont,3436
2015,277,Clemson,30,9,21,1768,58.9,clemson,3155
2015,278,Georgia,31,19,12,1826,58.9,georgia,3208
2015,279,Nevada,30,9,21,1761,58.7,nevada,3305
2015,280,Towson,32,11,21,1875,58.6,towson,3406
2015,281,Cornell,28,15,13,1640,58.6,cornell,3165
2015,281,Yale,28,13,15,1640,58.6,yale,3463
2015,283,New Orleans,27,8,19,1581,58.6,new orleans,3309
2015,284,Hartford,33,16,17,1932,58.5,hartford,3216
2015,285,Coppin St.,29,7,22,1697,58.5,coppin st.,3164
2015,286,Memphis,31,14,17,1811,58.4,memphis,3272
2015,287,Central Ark.,31,17,14,1810,58.4,central ark.,3146
2015,288,UC Irvine,32,8,24,1867,58.3,uc irvine,3414
2015,289,Texas Tech,31,15,16,1808,58.3,texas tech,3403
2015,290,Binghamton,30,4,26,1749,58.3,binghamton,3127
2015,291,Arizona,30,10,20,1743,58.1,arizona,3112
2015,292,Radford,31,17,14,1800,58.1,radford,3347
2015,292,Lafayette,31,14,17,1800,58.1,lafayette,3248
2015,294,FIU,29,3,26,1682,58,fiu,3198
2015,295,Rhode Island,30,17,13,1738,57.9,rhode island,3348
2015,296,Bradley,30,6,24,1735,57.8,bradley,3133
2015,297,Colgate,31,9,22,1789,57.7,colgate,3159
2015,298,Auburn,31,13,18,1786,57.6,auburn,3120
2015,299,Drexel,31,20,11,1784,57.5,drexel,3180
2015,300,Charleston So.,30,5,25,1723,57.4,charleston so.,3149
2015,301,Fairfield,31,15,16,1776,57.3,fairfield,3193
2015,302,Bethune-Cookman,30,13,17,1718,57.3,bethune-cookman,3126
2015,303,Morgan St.,30,11,19,1715,57.2,morgan st.,3288
2015,303,Mt. St. Mary's,30,8,22,1715,57.2,mt. st. mary's,3291
2015,305,San Diego St.,31,12,19,1769,57.1,san diego st.,3361
2015,306,UMKC,30,6,24,1710,57,umkc,3282
2015,307,Virginia Tech,32,12,20,1822,56.9,virginia tech,3439
2015,308,Wofford,30,8,22,1695,56.5,wofford,3459
2015,309,Davidson,30,5,25,1691,56.4,davidson,3172
2015,310,South Ala.,29,5,24,1630,56.2,south ala.,3375
2015,311,Grambling,30,10,20,1685,56.2,grambling,3212
2015,312,Portland St.,29,4,25,1627,56.1,portland st.,3340
2015,312,Florida A&M,29,8,21,1627,56.1,florida a&m,3197
2015,314,NJIT,29,12,17,1623,56,njit,3312
2015,315,Col. of Charleston,30,5,25,1676,55.9,col. of charleston,3158
2015,316,Navy,31,17,14,1731,55.8,navy,3298
2015,317,Bowling Green,30,9,21,1674,55.8,bowling green,3132
2015,317,Longwood,30,4,26,1674,55.8,longwood,3255
2015,319,Dartmouth,28,14,14,1562,55.8,dartmouth,3171
2015,320,SMU,30,7,23,1665,55.5,smu,3374
2015,321,Boston U.,30,5,25,1664,55.5,boston u.,3131
2015,322,Kent St.,30,5,25,1661,55.4,kent st.,3245
2015,323,Presbyterian,31,16,15,1715,55.3,presbyterian,3342
2015,324,Miami (OH),30,7,23,1656,55.2,miami (oh),3275
2015,325,Loyola Chicago,31,6,25,1710,55.2,loyola chicago,3260
2015,326,Utah,30,9,21,1646,54.9,utah,3428
2015,327,Rider,31,11,20,1698,54.8,rider,3351
2015,328,Northern Ill.,29,12,17,1588,54.8,northern ill.,3296
2015,329,Cincinnati,31,8,23,1695,54.7,cincinnati,3153
2015,330,Ark.-Pine Bluff,29,7,22,1566,54,ark.-pine bluff,3115
2015,331,Alcorn,28,10,18,1510,53.9,alcorn,3108
2015,332,Air Force,30,2,28,1614,53.8,air force,3102
2015,333,Houston,30,6,24,1598,53.3,houston,3222
2015,334,Chicago St.,29,4,25,1532,52.8,chicago st.,3152
2015,335,Loyola Maryland,30,7,23,1580,52.7,loyola maryland,3259
2015,336,North Florida,30,11,19,1573,52.4,north florida,3316
2015,337,Illinois St.,30,2,28,1572,52.4,illinois st.,3229
2015,338,N.C. Central,29,7,22,1505,51.9,n.c. central,3300
2015,339,North Texas,29,5,24,1503,51.8,north texas,3317
2015,340,Manhattan,30,3,27,1550,51.7,manhattan,3264
2015,341,Saint Peter's,31,5,26,1568,50.6,saint peter's,3389
2015,342,Mississippi Val.,30,4,26,1512,50.4,mississippi val.,3290
2015,343,UC Santa Barbara,29,2,27,1389,47.9,uc santa barbara,3364
2016,1,UConn,38,38,0,3346,88.1,uconn,3163
2016,2,Sacramento St.,31,14,17,2713,87.5,sacramento st.,3170
2016,3,Ohio St.,34,26,8,2925,86,ohio st.,3326
2016,4,Minnesota,32,20,12,2676,83.6,minnesota,3278
2016,5,Maryland,35,31,4,2912,83.2,maryland,3268
2016,6,DePaul,36,27,9,2913,80.9,depaul,3177
2016,7,Troy,33,20,13,2647,80.2,troy,3407
2016,8,Notre Dame,35,33,2,2801,80,notre dame,3323
2016,9,Drake,33,23,10,2627,79.6,drake,3179
2016,10,Morehead St.,30,10,20,2383,79.4,morehead st.,3287
2016,11,Michigan,35,21,14,2751,78.6,michigan,3276
2016,12,South Dakota,38,32,6,2971,78.2,south dakota,3377
2016,13,UC Riverside,32,23,9,2491,77.8,uc riverside,3415
2016,14,Baylor,38,36,2,2951,77.7,baylor,3124
2016,15,Marquette,30,14,16,2321,77.4,marquette,3266
2016,16,Florida,31,22,9,2398,77.4,florida,3196
2016,17,Western Ill.,32,16,16,2434,76.1,western ill.,3442
2016,18,Michigan St.,34,25,9,2581,75.9,michigan st.,3277
2016,19,Wright St.,35,24,11,2655,75.9,wright st.,3460
2016,20,Princeton,29,23,6,2193,75.6,princeton,3343
2016,21,Oakland,30,15,15,2262,75.4,oakland,3324
2016,22,Arkansas St.,33,27,6,2475,75,arkansas st.,3117
2016,23,Montana St.,31,21,10,2322,74.9,montana st.,3286
2016,24,Kentucky,33,25,8,2465,74.7,kentucky,3246
2016,25,Charlotte,31,19,12,2315,74.7,charlotte,3150
2016,26,Idaho,34,24,10,2539,74.7,idaho,3225
2016,27,Belmont,33,24,9,2464,74.7,belmont,3125
2016,28,Saint Mary's (CA),32,24,8,2388,74.6,saint mary's (ca),3388
2016,29,Northwestern,35,18,17,2611,74.6,northwestern,3321
2016,30,Saint Francis (PA),31,14,17,2310,74.5,saint francis (pa),3384
2016,31,Central Mich.,33,22,11,2443,74,central mich.,3141
2016,32,UCLA,35,26,9,2583,73.8,ucla,3417
2016,33,South Carolina,35,33,2,2575,73.6,south carolina,3376
2016,34,Florida St.,33,25,8,2424,73.5,florida st.,3199
2016,35,Seton Hall,32,23,9,2345,73.3,seton hall,3371
2016,36,Iowa,33,19,14,2416,73.2,iowa,3234
2016,37,UT Martin,32,22,10,2337,73,ut martin,3404
2016,38,Oregon,35,24,11,2545,72.7,oregon,3332
2016,39,South Fla.,34,24,10,2472,72.7,south fla.,3378
2016,40,Nebraska,31,18,13,2253,72.7,nebraska,3304
2016,41,Syracuse,38,30,8,2755,72.5,syracuse,3393
2016,42,SIUE,31,18,13,2245,72.4,siena,3373
2016,43,TCU,33,18,15,2384,72.2,tcu,3395
2016,44,San Jose St.,30,13,17,2167,72.2,san jose st.,3363
2016,45,Louisville,34,26,8,2454,72.2,louisville,3257
2016,46,Eastern Ky.,30,18,12,2164,72.1,eastern ky.,3184
2016,47,Ohio,33,26,7,2375,72,ohio,3325
2016,48,Eastern Mich.,34,22,12,2445,71.9,eastern mich.,3185
2016,49,Eastern Wash.,32,20,12,2298,71.8,eastern wash.,3186
2016,50,Duquesne,34,28,6,2441,71.8,duquesne,3182
2016,51,San Francisco,33,21,12,2363,71.6,san francisco,3362
2016,52,Indiana,33,21,12,2361,71.5,indiana,3231
2016,53,Washington,37,26,11,2642,71.4,washington,3449
2016,54,Akron,33,19,14,2353,71.3,akron,3103
2016,55,George Washington,33,26,7,2349,71.2,george washington,3203
2016,56,Texas,36,31,5,2560,71.1,texas,3400
2016,57,UTEP,34,29,5,2416,71.1,utep,3431
2016,58,McNeese,33,20,13,2344,71,mcneese st,3270
2016,59,Southeast Mo. St.,30,15,15,2123,70.8,southeast mo. st.,3369
2016,60,Western Ky.,34,27,7,2406,70.8,western ky.,3443
2016,61,Miami (FL),33,24,9,2334,70.7,miami (fl),3274
2016,62,Weber St.,35,23,12,2475,70.7,weber st.,3451
2016,63,West Virginia,35,25,10,2470,70.6,west virginia,3452
2016,64,Marshall,33,21,12,2325,70.5,marshall,3267
2016,65,Texas A&M,32,22,10,2254,70.4,texas a&m,3401
2016,66,Albany (NY),33,28,5,2322,70.4,albany (ny),3107
2016,67,Missouri St.,34,24,10,2390,70.3,missouri st.,3283
2016,67,Saint Louis,34,26,8,2390,70.3,saint louis,3387
2016,69,Army West Point,32,29,3,2249,70.3,armstrong,3118
2016,70,Detroit Mercy,30,15,15,2105,70.2,detroit mercy,3178
2016,71,Temple,35,23,12,2455,70.1,temple,3396
2016,72,South Dakota St.,34,27,7,2383,70.1,south dakota st.,3355
2016,73,Penn St.,31,12,19,2172,70.1,penn st.,3336
2016,74,BYU,33,26,7,2299,69.7,byu,3140
2016,75,Oklahoma,33,22,11,2297,69.6,oklahoma,3328
2016,76,Middle Tenn.,33,24,9,2296,69.6,middle tenn.,3292
2016,77,Lamar University,31,12,19,2153,69.5,american university,3110
2016,78,Loyola Marymount,31,11,20,2152,69.4,loyola marymount,3258
2016,79,James Madison,33,27,6,2290,69.4,james madison,3241
2016,80,Pacific,30,13,17,2078,69.3,pacific,3334
2016,81,Southern Ill.,33,20,13,2284,69.2,southern ill.,3356
2016,82,Mississippi St.,36,28,8,2490,69.2,mississippi st.,3280
2016,83,Austin Peay,30,10,20,2072,69.1,austin peay,3122
2016,84,Montana,31,20,11,2141,69.1,montana,3285
2016,85,Georgia Tech,33,20,13,2275,68.9,georgia tech,3210
2016,86,Ball St.,32,22,10,2202,68.8,ball st.,3123
2016,87,Stanford,35,27,8,2408,68.8,stanford,3390
2016,88,Utah,33,18,15,2266,68.7,utah,3428
2016,88,Boise St.,30,19,11,2060,68.7,boise st.,3129
2016,90,New Mexico St.,31,26,5,2127,68.6,new mexico st.,3308
2016,91,Illinois,30,9,21,2056,68.5,illinois,3228
2016,92,San Diego,33,25,8,2261,68.5,san diego,3360
2016,93,UC Davis,32,19,13,2191,68.5,uc davis,3413
2016,94,Duke,32,20,12,2189,68.4,duke,3181
2016,95,Brown,28,15,13,1912,68.3,brown,3135
2016,96,UNC Asheville,33,26,7,2252,68.2,unc asheville,3421
2016,97,Colorado St.,33,31,2,2243,68,colorado st.,3161
2016,98,Missouri,32,22,10,2175,68,missouri,3281
2016,99,Memphis,31,18,13,2104,67.9,memphis,3272
2016,100,Dayton,29,14,15,1967,67.8,dayton,3173
2016,101,SFA,30,18,12,2032,67.7,utsa,3427
2016,102,USC Upstate,34,22,12,2301,67.7,usc upstate,3367
2016,103,California,32,15,17,2162,67.6,california,3143
2016,103,East Carolina,32,13,19,2162,67.6,east carolina,3187
2016,105,Bryant,31,18,13,2093,67.5,bryant,3136
2016,106,NC State,31,20,11,2092,67.5,nc state,3301
2016,107,Quinnipiac,34,25,9,2294,67.5,quinnipiac,3346
2016,108,Louisiana Tech,30,14,16,2023,67.4,louisiana tech,3256
2016,108,Northern Ill.,30,11,19,2023,67.4,northern ill.,3296
2016,110,Iowa St.,30,13,17,2022,67.4,iowa st.,3235
2016,111,Purdue,32,20,12,2155,67.3,purdue,3345
2016,112,Fla. Atlantic,30,14,16,2019,67.3,fla. atlantic,3194
2016,113,North Carolina,32,14,18,2151,67.2,north carolina,3314
2016,114,Murray St.,29,12,17,1947,67.1,murray st.,3293
2016,115,Utah St.,31,14,17,2081,67.1,utah st.,3429
2016,116,IUPUI,32,21,11,2148,67.1,iupui,3237
2016,117,Oregon St.,37,32,5,2475,66.9,oregon st.,3333
2016,118,Portland St.,30,4,26,2006,66.9,portland st.,3340
2016,119,Stetson,32,20,12,2139,66.8,stetson,3391
2016,120,Toledo,30,17,13,2005,66.8,toledo,3405
2016,121,Lehigh,31,18,13,2070,66.8,lehigh,3250
2016,122,St. John's (NY),33,23,10,2201,66.7,st. john's (ny),3385
2016,123,Milwaukee,32,19,13,2131,66.6,milwaukee,3454
2016,124,Southern California,32,19,13,2130,66.6,southern california,3425
2016,125,Appalachian St.,30,10,20,1988,66.3,appalachian st.,3111
2016,126,Monmouth,31,14,17,2053,66.2,monmouth,3284
2016,127,Green Bay,33,28,5,2184,66.2,green bay,3453
2016,128,Bucknell,33,25,8,2180,66.1,bucknell,3137
2016,129,Columbia,29,12,17,1915,66,columbia,3162
2016,130,Gonzaga,33,19,14,2175,65.9,gonzaga,3211
2016,131,Utah Valley,31,16,15,2043,65.9,utah valley,3430
2016,132,Western Mich.,32,17,15,2106,65.8,western mich.,3444
2016,133,Harvard,28,14,14,1842,65.8,harvard,3217
2016,134,Tennessee,36,22,14,2362,65.6,tennessee,3397
2016,135,Fort Wayne,30,7,23,1965,65.5,iupu-fort wayne,3236
2016,135,UNCG,30,8,22,1965,65.5,unc,3314
2016,137,Santa Clara,32,23,9,2095,65.5,santa clara,3365
2016,138,Sacred Heart,33,20,13,2154,65.3,sacred heart,3357
2016,139,Youngstown St.,34,21,13,2219,65.3,youngstown st.,3464
2016,140,Northern Ariz.,30,6,24,1956,65.2,northern ariz.,3319
2016,141,Oklahoma St.,31,21,10,2018,65.1,oklahoma st.,3329
2016,142,Central Ark.,32,28,4,2083,65.1,central ark.,3146
2016,143,Houston Baptist,29,14,15,1887,65.1,houston baptist,3223
2016,144,Loyola Chicago,30,14,16,1952,65.1,loyola chicago,3260
2016,145,Grambling,31,17,14,2016,65,grambling,3212
2016,146,High Point,31,12,19,2015,65,high point,3219
2016,147,Jacksonville,33,22,11,2144,65,jacksonville,3239
2016,148,Creighton,35,17,18,2272,64.9,creighton,3166
2016,149,North Dakota St.,29,7,22,1881,64.9,north dakota st.,3295
2016,150,Fairleigh Dickinson,32,11,21,2075,64.8,fairleigh dickinson,3192
2016,151,Georgetown,30,16,14,1943,64.8,georgetown,3207
2016,152,FGCU,39,33,6,2525,64.7,fgcu,3195
2016,153,Ole Miss,30,10,20,1941,64.7,ole miss,3279
2016,154,Washington St.,30,14,16,1938,64.6,washington st.,3450
2016,155,Hawaii,32,21,11,2067,64.6,hawaii,3218
2016,156,Mercer,33,24,9,2129,64.5,mercer,3273
2016,157,Kansas St.,32,19,13,2062,64.4,kansas st.,3243
2016,158,Tulane,35,23,12,2254,64.4,tulane,3408
2016,158,Massachusetts,30,12,18,1932,64.4,massachusetts,3269
2016,160,Hofstra,34,25,9,2188,64.4,hofstra,3220
2016,161,Sam Houston St.,32,14,18,2059,64.3,sam houston st.,3358
2016,162,Wisconsin,29,7,22,1864,64.3,wisconsin,3458
2016,163,Yale,31,14,17,1991,64.2,yale,3463
2016,164,Georgia St.,29,10,19,1858,64.1,georgia st.,3209
2016,165,North Dakota,33,19,14,2113,64,north dakota,3315
2016,166,Arizona St.,33,26,7,2110,63.9,arizona st.,3113
2016,167,VCU,33,23,10,2109,63.9,vcu,3433
2016,168,Georgia,31,21,10,1981,63.9,georgia,3208
2016,169,Robert Morris,33,20,13,2107,63.8,robert morris,3352
2016,170,Nicholls St.,29,10,19,1849,63.8,nicholls st.,3311
2016,171,Louisiana,35,25,10,2231,63.7,se louisiana,3368
2016,172,Alabama,31,15,16,1975,63.7,alabama,3104
2016,173,Omaha,30,15,15,1911,63.7,omaha,3303
2016,174,Elon,31,18,13,1974,63.7,elon,3189
2016,175,UNI,35,24,11,2228,63.7,uni,3320
2016,176,Pepperdine,31,7,24,1973,63.6,pepperdine,3337
2016,177,Valparaiso,31,10,21,1970,63.5,valparaiso,3434
2016,178,Furman,31,15,16,1968,63.5,furman,3202
2016,179,Virginia,34,18,16,2158,63.5,virginia,3438
2016,180,Idaho St.,33,18,15,2093,63.4,idaho st.,3226
2016,181,Northwestern St.,31,19,12,1965,63.4,northwestern st.,3322
2016,181,Howard,31,7,24,1965,63.4,howard,3224
2016,183,Texas Tech,31,13,18,1963,63.3,texas tech,3403
2016,184,Villanova,32,20,12,2026,63.3,villanova,3437
2016,185,Florida A&M,31,16,15,1962,63.3,florida a&m,3197
2016,186,Wyoming,29,13,16,1835,63.3,wyoming,3461
2016,187,CSU Bakersfield,31,12,19,1958,63.2,cs bakersfield,3167
2016,188,Coastal Caro.,30,12,18,1894,63.1,coastal caro.,3157
2016,189,Northern Colo.,29,13,16,1830,63.1,northern colo.,3294
2016,190,Cal Poly,31,15,16,1955,63.1,cal poly,3142
2016,191,UCF,30,7,23,1890,63,ucf,3416
2016,192,Long Beach St.,33,24,9,2078,63,long beach st.,3253
2016,193,UTRGV,33,19,14,2077,62.9,utrgv,3410
2016,194,Southern U.,31,19,12,1951,62.9,southern u.,3380
2016,194,N.C. A&T,31,19,12,1951,62.9,n.c. a&t,3299
2016,196,Alabama St.,31,19,12,1949,62.9,alabama st.,3106
2016,197,Prairie View,28,13,15,1760,62.9,prairie view,3341
2016,198,Saint Joseph's,29,14,15,1822,62.8,saint joseph's,3386
2016,199,St. Bonaventure,32,24,8,2010,62.8,st. bonaventure,3382
2016,200,Fresno St.,34,22,12,2135,62.8,fresno st.,3201
2016,201,Southeastern La.,29,4,25,1821,62.8,southeastern la.,3368
2016,202,Coppin St.,32,16,16,2009,62.8,coppin st.,3164
2016,203,Lipscomb,30,5,25,1882,62.7,lipscomb,3252
2016,204,George Mason,31,12,19,1940,62.6,george mason,3206
2016,205,Penn,29,24,5,1813,62.5,penn,3335
2016,206,Vanderbilt,32,18,14,2000,62.5,vanderbilt,3435
2016,206,Jackson St.,30,14,16,1875,62.5,jackson st.,3238
2016,208,Iona,35,23,12,2187,62.5,iona,3233
2016,209,Gardner-Webb,31,19,12,1936,62.5,gardner-webb,3205
2016,210,Western Caro.,29,7,22,1811,62.4,western caro.,3441
2016,211,CSUN,31,7,24,1933,62.4,lsu,3261
2016,212,Marist,32,16,16,1993,62.3,marist,3265
2016,213,Old Dominion,34,17,17,2117,62.3,old dominion,3330
2016,213,Rutgers,34,19,15,2117,62.3,rutgers,3353
2016,215,William & Mary,30,15,15,1862,62.1,william & mary,3456
2016,216,Auburn,33,20,13,2048,62.1,auburn,3120
2016,217,Tulsa,31,12,19,1922,62,tulsa,3409
2016,218,Colorado,30,7,23,1858,61.9,colorado,3160
2016,219,Cleveland St.,29,9,20,1795,61.9,cleveland st.,3156
2016,220,Ill.-Chicago,30,12,18,1854,61.8,ill.-chicago,3227
2016,221,Tennessee Tech,29,10,19,1791,61.8,tennessee tech,3399
2016,222,UTSA,29,10,19,1790,61.7,utsa,3427
2016,223,UC Santa Barbara,32,12,20,1973,61.7,uc santa barbara,3364
2016,224,UAB,31,15,16,1911,61.6,uab,3412
2016,225,Cornell,28,14,14,1725,61.6,cornell,3165
2016,226,Tennessee St.,30,12,18,1847,61.6,tennessee st.,3398
2016,227,Kent St.,29,6,23,1782,61.4,kent st.,3245
2016,228,Texas St.,31,12,19,1904,61.4,texas st.,3402
2016,229,Towson,31,7,24,1903,61.4,towson,3406
2016,230,New Mexico,32,17,15,1963,61.3,new mexico,3307
2016,231,North Texas,30,11,19,1838,61.3,north texas,3317
2016,232,UNLV,32,18,14,1959,61.2,unlv,3424
2016,233,Buffalo,34,20,14,2081,61.2,buffalo,3138
2016,234,Northeastern,31,15,16,1897,61.2,northeastern,3318
2016,235,Canisius,30,13,17,1834,61.1,canisius,3145
2016,236,Manhattan,31,15,16,1895,61.1,manhattan,3264
2016,237,Alcorn,30,11,19,1832,61.1,alcorn,3108
2016,238,Hampton,31,14,17,1891,61,hampton,3214
2016,238,New Orleans,27,8,19,1647,61,new orleans,3309
2016,240,Liberty,33,20,13,2008,60.8,liberty,3251
2016,241,Bethune-Cookman,31,18,13,1884,60.8,bethune-cookman,3126
2016,242,Wake Forest,33,17,16,2004,60.7,wake forest,3448
2016,243,Presbyterian,31,18,13,1880,60.6,presbyterian,3342
2016,244,Rhode Island,30,12,18,1819,60.6,rhode island,3348
2016,245,Xavier,30,17,13,1815,60.5,xavier,3462
2016,246,Maine,35,26,9,2117,60.5,maine,3263
2016,247,Holy Cross,30,13,17,1814,60.5,holy cross,3221
2016,248,Delaware St.,30,9,21,1809,60.3,delaware st.,3175
2016,249,ETSU,30,16,14,1808,60.3,etsu,3190
2016,250,Wagner,29,5,24,1747,60.2,wagner,3447
2016,250,Wofford,29,9,20,1747,60.2,wofford,3459
2016,252,Seattle U,30,9,21,1807,60.2,seattle,3370
2016,253,Eastern Ill.,28,3,25,1684,60.1,eastern ill.,3183
2016,254,Arkansas,30,12,18,1804,60.1,arkansas,3116
2016,255,SMU,31,13,18,1864,60.1,smu,3374
2016,256,Drexel,33,19,14,1983,60.1,drexel,3180
2016,257,Radford,31,18,13,1862,60.1,radford,3347
2016,258,Pittsburgh,31,13,18,1857,59.9,pittsburgh,3338
2016,259,Miami (OH),30,9,21,1796,59.9,miami (oh),3275
2016,260,Kennesaw St.,30,11,19,1791,59.7,kennesaw st.,3244
2016,261,Davidson,30,11,19,1788,59.6,davidson,3172
2016,262,Little Rock,33,20,13,1966,59.6,little rock,3114
2016,263,Boston College,31,15,16,1845,59.5,boston college,3130
2016,264,Texas Southern,30,19,11,1785,59.5,texas southern,3411
2016,265,FIU,31,5,26,1841,59.4,fiu,3198
2016,266,Norfolk St.,27,3,24,1603,59.4,norfolk st.,3313
2016,267,UT Arlington,31,15,16,1838,59.3,ut arlington,3426
2016,268,A&M-Corpus Christi,29,9,20,1718,59.2,a&m-corpus chris,3394
2016,269,Rice,31,9,22,1835,59.2,rice,3349
2016,270,Southern Miss.,30,14,16,1770,59,southern miss.,3379
2016,271,Colgate,30,7,23,1768,58.9,colgate,3159
2016,272,Central Conn. St.,30,12,18,1766,58.9,central conn. st.,3148
2016,273,Oral Roberts,30,14,16,1763,58.8,oral roberts,3331
2016,274,Bowling Green,28,10,18,1645,58.8,bowling green,3132
2016,275,Southern Utah,29,4,25,1702,58.7,southern utah,3381
2016,276,UMKC,28,10,18,1642,58.6,umkc,3282
2016,277,Charleston So.,31,14,17,1814,58.5,charleston so.,3149
2016,278,Stony Brook,32,17,15,1872,58.5,stony brook,3392
2016,279,Fairfield,31,16,15,1813,58.5,fairfield,3193
2016,280,La.-Monroe,29,12,17,1696,58.5,la.-monroe,3419
2016,281,Portland,30,3,27,1754,58.5,portland,3339
2016,282,Longwood,30,8,22,1753,58.4,longwood,3255
2016,283,Virginia Tech,32,18,14,1868,58.4,virginia tech,3439
2016,284,Ark.-Pine Bluff,30,9,21,1750,58.3,ark.-pine bluff,3115
2016,285,Butler,31,10,21,1808,58.3,butler,3139
2016,286,St. Francis Brooklyn,29,7,22,1691,58.3,st. francis brooklyn,3383
2016,287,La Salle,30,5,25,1749,58.3,la salle,3247
2016,288,Delaware,31,16,15,1807,58.3,delaware,3174
2016,289,Indiana St.,30,13,17,1748,58.3,indiana st.,3232
2016,290,Rider,30,8,22,1745,58.2,rider,3351
2016,291,San Diego St.,31,12,19,1802,58.1,san diego st.,3361
2016,292,LIU Brooklyn,30,9,21,1740,58,liu brooklyn,3254
2016,293,UMBC,32,18,14,1852,57.9,umbc,3420
2016,294,Alabama A&M,30,5,25,1736,57.9,alabama a&m,3105
2016,295,Lafayette,29,6,23,1675,57.8,lafayette,3248
2016,296,Chattanooga,32,24,8,1847,57.7,chattanooga,3151
2016,297,New Hampshire,30,12,18,1725,57.5,new hampshire,3306
2016,298,UMES,29,12,17,1664,57.4,umes,3271
2016,299,Cincinnati,30,8,22,1712,57.1,cincinnati,3153
2016,300,Siena,32,14,18,1825,57,siena,3373
2016,301,Arizona,32,13,19,1820,56.9,arizona,3112
2016,302,Campbell,31,13,18,1760,56.8,campbell,3144
2016,303,Providence,29,5,24,1646,56.8,providence,3344
2016,304,Mt. St. Mary's,30,9,21,1696,56.5,mt. st. mary's,3291
2016,305,North Florida,30,7,23,1695,56.5,north florida,3316
2016,306,South Ala.,30,15,15,1694,56.5,south ala.,3375
2016,307,UC Irvine,31,4,27,1750,56.5,uc irvine,3414
2016,308,Nevada,30,5,25,1693,56.4,nevada,3305
2016,309,South Carolina St.,29,13,16,1633,56.3,south carolina st.,3354
2016,310,Binghamton,31,14,17,1738,56.1,binghamton,3127
2016,310,Niagara,31,8,23,1738,56.1,niagara,3310
2016,312,Vermont,30,9,21,1677,55.9,vermont,3436
2016,313,Cal St. Fullerton,30,3,27,1674,55.8,cal st. fullerton,3168
2016,314,Richmond,31,13,18,1729,55.8,richmond,3350
2016,315,Houston,30,6,24,1670,55.7,houston,3222
2016,316,Illinois St.,30,8,22,1667,55.6,illinois st.,3229
2016,317,Col. of Charleston,31,11,20,1722,55.5,col. of charleston,3158
2016,318,Fordham,31,14,17,1721,55.5,fordham,3200
2016,319,Samford,31,20,11,1719,55.5,samford,3359
2016,320,Bradley,31,9,22,1714,55.3,bradley,3133
2016,321,Jacksonville St.,28,10,18,1543,55.1,jacksonville st.,3240
2016,322,Navy,30,15,15,1652,55.1,navy,3298
2016,323,Evansville,31,3,28,1696,54.7,evansville,3191
2016,324,Dartmouth,30,12,18,1639,54.6,dartmouth,3171
2016,325,Loyola Maryland,32,16,16,1746,54.6,loyola maryland,3259
2016,326,LSU,31,10,21,1688,54.5,lsu,3261
2016,327,Kansas,31,6,25,1687,54.4,kansas,3242
2016,328,Morgan St.,30,13,17,1628,54.3,morgan st.,3288
2016,329,Chicago St.,29,4,25,1573,54.2,chicago st.,3152
2016,330,American,31,8,23,1672,53.9,american,3110
2016,331,Denver,30,5,25,1605,53.5,denver,3176
2016,332,Winthrop,30,4,26,1602,53.4,winthrop,3457
2016,333,Ga. Southern,29,7,22,1539,53.1,ga. southern,3204
2016,334,UNCW,30,7,23,1590,53,unc,3314
2016,335,Savannah St.,28,10,18,1480,52.9,savannah st.,3366
2016,336,Wichita St.,30,8,22,1583,52.8,wichita st.,3455
2016,337,Clemson,30,4,26,1568,52.3,clemson,3155
2016,338,Boston U.,30,3,27,1548,51.6,boston u.,3131
2016,339,Saint Peter's,30,4,26,1541,51.4,saint peter's,3389
2016,340,N.C. Central,28,5,23,1424,50.9,n.c. central,3300
2016,341,NJIT,30,4,26,1493,49.8,njit,3312
2016,342,Mississippi Val.,29,3,26,1435,49.5,mississippi val.,3290
2016,343,Hartford,30,11,19,1466,48.9,hartford,3216
2016,344,Air Force,30,1,29,1422,47.4,air force,3102
2017,1,Baylor,37,33,4,3312,89.5,baylor,3124
2017,2,Maryland,35,32,3,3125,89.3,maryland,3268
2017,3,UConn,37,36,1,3222,87.1,uconn,3163
2017,4,Ohio St.,35,28,7,2999,85.7,ohio st.,3326
2017,5,Northern Ill.,33,21,12,2808,85.1,northern ill.,3296
2017,6,Washington,35,29,6,2975,85,washington,3449
2017,7,Troy,33,22,11,2721,82.5,troy,3407
2017,8,Sacramento St.,30,10,20,2471,82.4,sacramento st.,3170
2017,9,Drake,33,28,5,2712,82.2,drake,3179
2017,10,DePaul,35,27,8,2824,80.7,depaul,3177
2017,11,Notre Dame,37,33,4,2963,80.1,notre dame,3323
2017,12,Western Ill.,33,26,7,2640,80,western ill.,3442
2017,13,Florida St.,35,28,7,2764,79,florida st.,3199
2017,14,Marquette,33,25,8,2602,78.8,marquette,3266
2017,15,Syracuse,33,22,11,2595,78.6,syracuse,3393
2017,16,Central Mich.,32,23,9,2490,77.8,central mich.,3141
2017,17,Belmont,33,27,6,2560,77.6,belmont,3125
2017,18,Michigan,37,28,9,2846,76.9,michigan,3276
2017,19,Oakland,30,18,12,2298,76.6,oakland,3324
2017,20,South Carolina,37,33,4,2824,76.3,south carolina,3376
2017,21,Iowa,34,20,14,2588,76.1,iowa,3234
2017,22,Mississippi St.,39,34,5,2961,75.9,mississippi st.,3280
2017,23,Saint Francis (PA),32,17,15,2409,75.3,saint francis (pa),3384
2017,24,Western Ky.,34,27,7,2553,75.1,western ky.,3443
2017,25,Indiana,34,23,11,2547,74.9,indiana,3231
2017,26,Ball St.,32,21,11,2387,74.6,ball st.,3123
2017,27,Louisville,37,29,8,2759,74.6,louisville,3257
2017,28,UCLA,34,25,9,2520,74.1,ucla,3417
2017,29,Texas,34,25,9,2517,74,texas,3400
2017,30,West Virginia,35,24,11,2589,74,west virginia,3452
2017,31,Oklahoma,33,23,10,2441,74,oklahoma,3328
2017,32,Southeast Mo. St.,30,13,17,2217,73.9,southeast mo. st.,3369
2017,33,Iowa St.,31,18,13,2289,73.8,iowa st.,3235
2017,34,Minnesota,31,15,16,2286,73.7,minnesota,3278
2017,35,Duke,34,28,6,2506,73.7,duke,3181
2017,36,Charlotte,31,21,10,2281,73.6,charlotte,3150
2017,37,Lamar University,30,22,8,2205,73.5,american university,3110
2017,38,Michigan St.,33,21,12,2421,73.4,michigan st.,3277
2017,39,South Dakota,32,23,9,2346,73.3,south dakota,3377
2017,39,Tennessee,32,20,12,2346,73.3,tennessee,3397
2017,41,Murray St.,29,15,14,2126,73.3,murray st.,3293
2017,42,SFA,33,25,8,2415,73.2,utsa,3427
2017,43,Saint Louis,34,25,9,2485,73.1,saint louis,3387
2017,44,Penn St.,32,21,11,2325,72.7,penn st.,3336
2017,45,Milwaukee,34,22,12,2463,72.4,milwaukee,3454
2017,46,Morehead St.,31,21,10,2242,72.3,morehead st.,3287
2017,47,Brown,30,17,13,2169,72.3,brown,3135
2017,48,Montana St.,32,25,7,2312,72.3,montana st.,3286
2017,49,North Carolina,31,15,16,2237,72.2,north carolina,3314
2017,50,New Orleans,29,14,15,2092,72.1,new orleans,3309
2017,51,Miami (FL),33,24,9,2379,72.1,miami (fl),3274
2017,52,Idaho,34,19,15,2451,72.1,idaho,3225
2017,53,Gonzaga,33,26,7,2375,72,gonzaga,3211
2017,54,FGCU,35,26,9,2515,71.9,fgcu,3195
2017,55,North Dakota,31,20,11,2227,71.8,north dakota,3315
2017,56,Stanford,38,32,6,2725,71.7,stanford,3390
2017,57,Marshall,30,13,17,2150,71.7,marshall,3267
2017,58,San Jose St.,32,11,21,2284,71.4,san jose st.,3363
2017,59,NC State,32,23,9,2278,71.2,nc state,3301
2017,60,Old Dominion,31,17,14,2202,71,old dominion,3330
2017,61,Kent St.,32,19,13,2273,71,kent st.,3245
2017,61,South Dakota St.,32,23,9,2273,71,south dakota st.,3355
2017,63,TCU,30,12,18,2129,71,tcu,3395
2017,64,Kentucky,33,22,11,2339,70.9,kentucky,3246
2017,65,Oregon,37,23,14,2622,70.9,oregon,3332
2017,66,Virginia Tech,34,20,14,2405,70.7,virginia tech,3439
2017,67,South Fla.,33,24,9,2334,70.7,south fla.,3378
2017,68,Northern Colo.,30,22,8,2121,70.7,northern colo.,3294
2017,69,Florida,31,15,16,2191,70.7,florida,3196
2017,70,Elon,34,27,7,2399,70.6,elon,3189
2017,71,Saint Mary's (CA),33,20,13,2328,70.5,saint mary's (ca),3388
2017,72,Toledo,34,25,9,2398,70.5,toledo,3405
2017,73,Detroit Mercy,32,18,14,2256,70.5,detroit mercy,3178
2017,74,UT Martin,31,12,19,2184,70.5,ut martin,3404
2017,75,Southern Miss.,34,23,11,2390,70.3,southern miss.,3379
2017,76,Stetson,33,26,7,2318,70.2,stetson,3391
2017,77,James Madison,35,26,9,2458,70.2,james madison,3241
2017,78,UTSA,30,14,16,2105,70.2,utsa,3427
2017,79,Middle Tenn.,34,23,11,2381,70,middle tenn.,3292
2017,80,Temple,32,24,8,2238,69.9,temple,3396
2017,81,Omaha,31,16,15,2164,69.8,omaha,3303
2017,82,McNeese,31,14,17,2163,69.8,mcneese st,3270
2017,83,Northern Ariz.,30,9,21,2088,69.6,northern ariz.,3319
2017,84,Green Bay,33,27,6,2290,69.4,green bay,3453
2017,85,New Mexico St.,31,24,7,2151,69.4,new mexico st.,3308
2017,86,Pacific,31,10,21,2149,69.3,pacific,3334
2017,86,Louisiana,31,20,11,2149,69.3,se louisiana,3368
2017,88,Ohio,32,22,10,2216,69.3,ohio,3325
2017,89,Western Mich.,32,19,13,2207,69,western mich.,3444
2017,90,Colorado,33,17,16,2275,68.9,colorado,3160
2017,91,UC Davis,33,25,8,2274,68.9,uc davis,3413
2017,92,Portland St.,33,16,17,2269,68.8,portland st.,3340
2017,93,SIUE,31,14,17,2131,68.7,siena,3373
2017,94,Texas A&M,34,22,12,2337,68.7,texas a&m,3401
2017,94,California,34,20,14,2337,68.7,california,3143
2017,96,Georgia Tech,37,22,15,2542,68.7,georgia tech,3210
2017,97,Vanderbilt,30,14,16,2061,68.7,vanderbilt,3435
2017,98,San Francisco,31,18,13,2129,68.7,san francisco,3362
2017,99,Boise St.,33,25,8,2266,68.7,boise st.,3129
2017,100,Wright St.,34,25,9,2331,68.6,wright st.,3460
2017,101,Central Ark.,31,26,5,2122,68.5,central ark.,3146
2017,102,Northwestern,31,20,11,2120,68.4,northwestern,3321
2017,102,UT Arlington,31,22,9,2120,68.4,ut arlington,3426
2017,104,Quinnipiac,36,29,7,2461,68.4,quinnipiac,3346
2017,105,Louisiana Tech,32,18,14,2186,68.3,louisiana tech,3256
2017,106,Rice,35,22,13,2388,68.2,rice,3349
2017,107,High Point,30,15,15,2046,68.2,high point,3219
2017,108,Alabama,36,22,14,2453,68.1,alabama,3104
2017,109,Texas Tech,31,14,17,2106,67.9,texas tech,3403
2017,110,Buffalo,32,22,10,2172,67.9,buffalo,3138
2017,111,Jacksonville,32,23,9,2170,67.8,jacksonville,3239
2017,112,Weber St.,31,13,18,2102,67.8,weber st.,3451
2017,113,Ole Miss,31,17,14,2095,67.6,ole miss,3279
2017,114,Southern California,30,14,16,2026,67.5,southern california,3425
2017,115,Kansas St.,34,23,11,2294,67.5,kansas st.,3243
2017,116,Youngstown St.,30,9,21,2024,67.5,youngstown st.,3464
2017,117,Cal Poly,29,11,18,1955,67.4,cal poly,3142
2017,118,BYU,32,20,12,2157,67.4,byu,3140
2017,119,Bucknell,33,27,6,2224,67.4,bucknell,3137
2017,120,Nicholls St.,30,10,20,2021,67.4,nicholls st.,3311
2017,121,Purdue,36,23,13,2425,67.4,purdue,3345
2017,122,Eastern Wash.,33,19,14,2221,67.3,eastern wash.,3186
2017,123,Colgate,30,10,20,2012,67.1,colgate,3159
2017,123,Nevada,30,11,19,2012,67.1,nevada,3305
2017,125,New Mexico,30,15,15,2011,67,new mexico,3307
2017,126,Austin Peay,30,14,16,2010,67,austin peay,3122
2017,127,Jackson St.,28,12,16,1875,67,jackson st.,3238
2017,128,UNI,33,24,9,2208,66.9,uni,3320
2017,129,Hartford,31,17,14,2072,66.8,hartford,3216
2017,130,IUPUI,33,24,9,2205,66.8,iupui,3237
2017,131,Army West Point,31,22,9,2066,66.6,armstrong,3118
2017,132,Northwestern St.,30,13,17,1999,66.6,northwestern st.,3322
2017,133,Washington St.,36,16,20,2398,66.6,washington st.,3450
2017,134,Navy,34,24,10,2261,66.5,navy,3298
2017,135,Southern Utah,30,7,23,1993,66.4,southern utah,3381
2017,136,UAB,30,15,15,1992,66.4,uab,3412
2017,137,Missouri,33,22,11,2189,66.3,missouri,3281
2017,138,CSUN,32,18,14,2121,66.3,lsu,3261
2017,139,Georgetown,30,17,13,1988,66.3,georgetown,3207
2017,140,Albany (NY),33,21,12,2186,66.2,albany (ny),3107
2017,141,Oklahoma St.,32,17,15,2118,66.2,oklahoma st.,3329
2017,142,Long Beach St.,34,23,11,2248,66.1,long beach st.,3253
2017,143,UC Riverside,31,16,15,2048,66.1,uc riverside,3415
2017,144,Loyola Marymount,30,14,16,1981,66,loyola marymount,3258
2017,145,Creighton,32,24,8,2107,65.8,creighton,3166
2017,146,Siena,30,14,16,1975,65.8,siena,3373
2017,147,Dayton,32,22,10,2106,65.8,dayton,3173
2017,147,Mercer,32,25,7,2106,65.8,mercer,3273
2017,149,UTEP,31,8,23,2039,65.8,utep,3431
2017,150,Eastern Ill.,28,9,19,1841,65.8,eastern ill.,3183
2017,151,Oregon St.,36,31,5,2363,65.6,oregon st.,3333
2017,152,Cleveland St.,30,14,16,1968,65.6,cleveland st.,3156
2017,153,Drexel,33,22,11,2163,65.5,drexel,3180
2017,154,George Washington,30,20,10,1966,65.5,george washington,3203
2017,155,Rider,33,24,9,2160,65.5,rider,3351
2017,156,Grambling,34,19,15,2213,65.1,grambling,3212
2017,157,Tennessee St.,26,10,16,1691,65,tennessee st.,3398
2017,158,Missouri St.,31,16,15,2016,65,missouri st.,3283
2017,159,ETSU,30,16,14,1950,65,etsu,3190
2017,160,Colorado St.,34,25,9,2209,65,colorado st.,3161
2017,161,Monmouth,31,15,16,2013,64.9,monmouth,3284
2017,162,San Diego,30,14,16,1948,64.9,san diego,3360
2017,163,Duquesne,34,18,16,2206,64.9,duquesne,3182
2017,164,Wichita St.,31,15,16,2011,64.9,wichita st.,3455
2017,165,Jacksonville St.,28,13,15,1816,64.9,jacksonville st.,3240
2017,166,Howard,29,16,13,1880,64.8,howard,3224
2017,167,Wyoming,32,22,10,2069,64.7,wyoming,3461
2017,167,Eastern Ky.,32,12,20,2069,64.7,eastern ky.,3184
2017,169,Utah,31,16,15,1998,64.5,utah,3428
2017,170,Col. of Charleston,30,9,21,1932,64.4,col. of charleston,3158
2017,171,Princeton,30,16,14,1931,64.4,princeton,3343
2017,172,Seton Hall,31,12,19,1991,64.2,seton hall,3371
2017,173,Columbia,27,13,14,1732,64.1,columbia,3162
2017,174,Arkansas,30,13,17,1924,64.1,arkansas,3116
2017,175,Southern Ill.,31,16,15,1987,64.1,southern ill.,3356
2017,176,Arizona,30,14,16,1920,64,arizona,3112
2017,177,Wake Forest,32,16,16,2047,64,wake forest,3448
2017,178,UNC Asheville,34,19,15,2174,63.9,unc asheville,3421
2017,179,CSU Bakersfield,29,15,14,1854,63.9,cs bakersfield,3167
2017,180,Southeastern La.,29,5,24,1853,63.9,southeastern la.,3368
2017,181,Arizona St.,33,20,13,2107,63.8,arizona st.,3113
2017,182,Harvard,30,21,9,1914,63.8,harvard,3217
2017,183,Seattle U,33,15,18,2103,63.7,seattle,3370
2017,184,Cincinnati,30,16,14,1911,63.7,cincinnati,3153
2017,185,Tulane,33,18,15,2101,63.7,tulane,3408
2017,185,UCF,33,21,12,2101,63.7,ucf,3416
2017,187,Tulsa,31,10,21,1973,63.6,tulsa,3409
2017,188,UNCG,35,20,15,2225,63.6,unc,3314
2017,189,Oral Roberts,30,15,15,1906,63.5,oral roberts,3331
2017,190,Saint Joseph's,32,17,15,2032,63.5,saint joseph's,3386
2017,190,San Diego St.,30,11,19,1905,63.5,san diego st.,3361
2017,192,Gardner-Webb,31,12,19,1968,63.5,gardner-webb,3205
2017,193,North Dakota St.,30,6,24,1904,63.5,north dakota st.,3295
2017,194,LSU,32,20,12,2030,63.4,lsu,3261
2017,195,Chattanooga,32,21,11,2027,63.3,chattanooga,3151
2017,196,VCU,31,16,15,1960,63.2,vcu,3433
2017,197,Southern U.,28,14,14,1770,63.2,southern u.,3380
2017,198,UTRGV,33,19,14,2086,63.2,utrgv,3410
2017,199,Lehigh,30,10,20,1896,63.2,lehigh,3250
2017,200,Virginia,33,20,13,2084,63.2,virginia,3438
2017,201,Fla. Atlantic,29,4,25,1830,63.1,fla. atlantic,3194
2017,202,William & Mary,31,20,11,1951,62.9,william & mary,3456
2017,203,Robert Morris,33,22,11,2074,62.8,robert morris,3352
2017,204,Appalachian St.,31,12,19,1948,62.8,appalachian st.,3111
2017,205,Prairie View,31,13,18,1947,62.8,prairie view,3341
2017,206,Sacred Heart,32,17,15,2009,62.8,sacred heart,3357
2017,207,Liberty,30,13,17,1883,62.8,liberty,3251
2017,208,Nebraska,29,7,22,1820,62.8,nebraska,3304
2017,208,Coastal Caro.,29,13,16,1820,62.8,coastal caro.,3157
2017,210,Norfolk St.,30,15,15,1880,62.7,norfolk st.,3313
2017,211,UC Santa Barbara,32,16,16,2004,62.6,uc santa barbara,3364
2017,212,Bowling Green,31,8,23,1941,62.6,bowling green,3132
2017,213,Akron,30,9,21,1878,62.6,akron,3103
2017,214,La Salle,30,17,13,1876,62.5,la salle,3247
2017,215,Auburn,32,17,15,1998,62.4,auburn,3120
2017,216,Illinois,31,9,22,1935,62.4,illinois,3228
2017,217,Towson,30,12,18,1869,62.3,towson,3406
2017,218,Denver,30,6,24,1868,62.3,denver,3176
2017,219,UMKC,29,10,19,1804,62.2,umkc,3282
2017,220,Xavier,30,12,18,1866,62.2,xavier,3462
2017,221,Cornell,27,16,11,1679,62.2,cornell,3165
2017,222,Georgia,31,16,15,1925,62.1,georgia,3208
2017,223,East Carolina,30,11,19,1861,62,east carolina,3187
2017,223,Providence,30,12,18,1861,62,providence,3344
2017,223,Santa Clara,30,14,16,1861,62,santa clara,3365
2017,226,USC Upstate,30,9,21,1859,62,usc upstate,3367
2017,226,Kansas,30,8,22,1859,62,kansas,3242
2017,228,Evansville,31,14,17,1920,61.9,evansville,3191
2017,228,Furman,31,14,17,1920,61.9,furman,3202
2017,230,Binghamton,30,13,17,1858,61.9,binghamton,3127
2017,230,Tennessee Tech,30,10,20,1858,61.9,tennessee tech,3399
2017,232,Valparaiso,31,10,21,1918,61.9,valparaiso,3434
2017,233,Central Conn. St.,31,11,20,1916,61.8,central conn. st.,3148
2017,234,Little Rock,34,25,9,2101,61.8,little rock,3114
2017,235,Wofford,30,13,17,1853,61.8,wofford,3459
2017,236,Marist,32,15,17,1972,61.6,marist,3265
2017,237,Hofstra,31,13,18,1908,61.5,hofstra,3220
2017,237,Eastern Mich.,31,6,25,1908,61.5,eastern mich.,3185
2017,239,Ga. Southern,30,13,17,1844,61.5,ga. southern,3204
2017,240,Georgia St.,30,12,18,1842,61.4,georgia st.,3209
2017,241,New Hampshire,32,26,6,1962,61.3,new hampshire,3306
2017,242,Penn,30,22,8,1838,61.3,penn,3335
2017,243,Villanova,35,20,15,2141,61.2,villanova,3437
2017,244,Houston,31,12,19,1896,61.2,houston,3222
2017,245,Miami (OH),32,11,21,1957,61.2,miami (oh),3275
2017,246,Yale,27,15,12,1651,61.1,yale,3463
2017,247,St. John's (NY),34,22,12,2078,61.1,st. john's (ny),3385
2017,248,Radford,33,24,9,2010,60.9,radford,3347
2017,249,Bradley,31,12,19,1888,60.9,bradley,3133
2017,250,Wisconsin,31,9,22,1887,60.9,wisconsin,3458
2017,251,Pittsburgh,30,13,17,1826,60.9,pittsburgh,3338
2017,252,American,31,15,16,1885,60.8,american,3110
2017,253,Pepperdine,30,7,23,1824,60.8,pepperdine,3337
2017,254,UMES,29,13,16,1763,60.8,umes,3271
2017,255,Bryant,32,18,14,1945,60.8,bryant,3136
2017,256,Texas Southern,33,23,10,2004,60.7,texas southern,3411
2017,257,Idaho St.,33,19,14,2003,60.7,idaho st.,3226
2017,258,N.C. A&T,32,14,18,1942,60.7,n.c. a&t,3299
2017,259,A&M-Corpus Christi,32,14,18,1941,60.7,a&m-corpus chris,3394
2017,260,George Mason,30,13,17,1817,60.6,george mason,3206
2017,261,Arkansas St.,32,7,25,1938,60.6,arkansas st.,3117
2017,262,Charleston So.,32,18,14,1937,60.5,charleston so.,3149
2017,263,Hampton,33,20,13,1996,60.5,hampton,3214
2017,264,North Texas,31,12,19,1875,60.5,north texas,3317
2017,265,North Florida,30,10,20,1808,60.3,north florida,3316
2017,265,Niagara,30,8,22,1808,60.3,niagara,3310
2017,267,UNLV,33,22,11,1988,60.2,unlv,3424
2017,268,UC Irvine,31,5,26,1867,60.2,uc irvine,3414
2017,269,Bethune-Cookman,32,21,11,1926,60.2,bethune-cookman,3126
2017,270,Fresno St.,33,18,15,1983,60.1,fresno st.,3201
2017,271,Loyola Maryland,31,11,20,1858,59.9,loyola maryland,3259
2017,272,Maine,34,18,16,2035,59.9,maine,3263
2017,273,Alabama St.,30,14,16,1794,59.8,alabama st.,3106
2017,274,Campbell,31,21,10,1852,59.7,campbell,3144
2017,275,UMBC,31,15,16,1849,59.6,umbc,3420
2017,276,Boston U.,30,13,17,1789,59.6,boston u.,3131
2017,277,Fordham,34,22,12,2025,59.6,fordham,3200
2017,278,Boston College,30,9,21,1782,59.4,boston college,3130
2017,279,Fairleigh Dickinson,30,8,22,1780,59.3,fairleigh dickinson,3192
2017,280,Iona,31,18,13,1836,59.2,iona,3233
2017,280,Canisius,31,10,21,1836,59.2,canisius,3145
2017,282,Hawaii,30,12,18,1776,59.2,hawaii,3218
2017,283,Mississippi Val.,30,10,20,1772,59.1,mississippi val.,3290
2017,284,Clemson,31,15,16,1831,59.1,clemson,3155
2017,285,Dartmouth,27,8,19,1591,58.9,dartmouth,3171
2017,286,Lipscomb,30,6,24,1765,58.8,lipscomb,3252
2017,287,Utah St.,32,17,15,1882,58.8,utah st.,3429
2017,288,Mt. St. Mary's,30,12,18,1763,58.8,mt. st. mary's,3291
2017,289,SMU,34,19,15,1997,58.7,smu,3374
2017,290,Texas St.,31,16,15,1817,58.6,texas st.,3402
2017,291,Ill.-Chicago,31,6,25,1815,58.5,ill.-chicago,3227
2017,292,Northeastern,31,12,19,1814,58.5,northeastern,3318
2017,293,Memphis,30,14,16,1752,58.4,memphis,3272
2017,294,Florida A&M,32,13,19,1865,58.3,florida a&m,3197
2017,295,St. Francis Brooklyn,30,8,22,1748,58.3,st. francis brooklyn,3383
2017,296,Portland,30,6,24,1747,58.2,portland,3339
2017,297,Fairfield,31,17,14,1804,58.2,fairfield,3193
2017,298,Alcorn,30,9,21,1742,58.1,alcorn,3108
2017,299,Utah Valley,31,9,22,1793,57.8,utah valley,3430
2017,300,Kennesaw St.,30,10,20,1734,57.8,kennesaw st.,3244
2017,301,Butler,31,6,25,1791,57.8,butler,3139
2017,302,Davidson,29,6,23,1664,57.4,davidson,3172
2017,303,Delaware St.,30,3,27,1718,57.3,delaware st.,3175
2017,304,Delaware,30,16,14,1713,57.1,delaware,3174
2017,305,Richmond,30,13,17,1710,57,richmond,3350
2017,306,Massachusetts,30,9,21,1709,57,massachusetts,3269
2017,307,Fort Wayne,29,5,24,1648,56.8,iupu-fort wayne,3236
2017,308,Stony Brook,30,12,18,1704,56.8,stony brook,3392
2017,309,Rhode Island,29,6,23,1645,56.7,rhode island,3348
2017,310,NJIT,30,11,19,1701,56.7,njit,3312
2017,311,Western Caro.,30,8,22,1699,56.6,western caro.,3441
2017,312,South Carolina St.,28,5,23,1585,56.6,south carolina st.,3354
2017,313,Ark.-Pine Bluff,30,12,18,1696,56.5,ark.-pine bluff,3115
2017,314,Holy Cross,30,8,22,1692,56.4,holy cross,3221
2017,315,La.-Monroe,30,6,24,1684,56.1,la.-monroe,3419
2017,316,Cal St. Fullerton,29,4,25,1625,56,cal st. fullerton,3168
2017,317,Northern Ky.,31,9,22,1730,55.8,northern ky.,3297
2017,318,St. Bonaventure,29,9,20,1611,55.6,st. bonaventure,3382
2017,319,Vermont,29,9,20,1608,55.4,vermont,3436
2017,320,FIU,29,5,24,1602,55.2,fiu,3198
2017,321,Montana,30,7,23,1655,55.2,montana,3285
2017,322,Samford,31,12,19,1710,55.2,samford,3359
2017,323,Indiana St.,30,12,18,1654,55.1,indiana st.,3232
2017,324,Longwood,30,4,26,1652,55.1,longwood,3255
2017,325,Manhattan,30,8,22,1648,54.9,manhattan,3264
2017,326,Presbyterian,31,13,18,1697,54.7,presbyterian,3342
2017,327,Houston Baptist,28,6,22,1532,54.7,houston baptist,3223
2017,328,Lafayette,32,4,28,1744,54.5,lafayette,3248
2017,329,UNCW,31,11,20,1689,54.5,unc,3314
2017,330,Coppin St.,29,8,21,1576,54.3,coppin st.,3164
2017,331,Illinois St.,31,8,23,1680,54.2,illinois st.,3229
2017,332,Saint Peter's,30,3,27,1617,53.9,saint peter's,3389
2017,333,Morgan St.,30,9,21,1609,53.6,morgan st.,3288
2017,334,Air Force,29,4,25,1551,53.5,air force,3102
2017,335,Chicago St.,29,0,29,1550,53.4,chicago st.,3152
2017,336,Wagner,29,4,25,1543,53.2,wagner,3447
2017,337,LIU Brooklyn,29,6,23,1537,53,liu brooklyn,3254
2017,338,Sam Houston St.,28,3,25,1481,52.9,sam houston st.,3358
2017,339,Savannah St.,31,12,19,1628,52.5,savannah st.,3366
2017,340,South Ala.,31,11,20,1606,51.8,south ala.,3375
2017,341,Winthrop,31,2,29,1602,51.7,winthrop,3457
2017,342,Rutgers,30,6,24,1516,50.5,rutgers,3353
2017,343,N.C. Central,29,8,21,1460,50.3,n.c. central,3300
2017,344,Alabama A&M,27,2,25,1316,48.7,alabama a&m,3105
2017,345,Loyola Chicago,30,2,28,1432,47.7,loyola chicago,3260
2018,1,UConn,29,29,0,2615,90.2,uconn,3163
2018,2,Baylor,29,28,1,2517,86.8,baylor,3124
2018,3,Ohio St.,30,24,6,2558,85.3,ohio st.,3326
2018,4,Notre Dame,29,27,2,2466,85,notre dame,3323
2018,5,Minnesota,29,22,7,2463,84.9,minnesota,3278
2018,6,Central Mich.,28,24,4,2344,83.7,central mich.,3141
2018,7,Mississippi St.,30,30,0,2505,83.5,mississippi st.,3280
2018,8,Drake,29,22,7,2409,83.1,drake,3179
2018,9,Oregon,31,27,4,2560,82.6,oregon,3332
2018,10,DePaul,30,23,7,2472,82.4,depaul,3177
2018,11,Western Ill.,29,21,8,2383,82.2,western ill.,3442
2018,12,Troy,28,16,12,2299,82.1,troy,3407
2018,13,Ball St.,28,23,5,2290,81.8,ball st.,3123
2018,14,Maryland,29,23,6,2369,81.7,maryland,3268
2018,15,Texas,29,24,5,2365,81.6,texas,3400
2018,16,Florida St.,29,24,5,2363,81.5,florida st.,3199
2018,17,Marquette,29,21,8,2359,81.3,marquette,3266
2018,18,Saint Francis (PA),28,19,9,2269,81,saint francis (pa),3384
2018,19,New Mexico,30,21,9,2403,80.1,new mexico,3307
2018,20,Oklahoma St.,29,20,9,2306,79.5,oklahoma st.,3329
2018,21,Belmont,32,29,3,2532,79.1,belmont,3125
2018,22,Iowa,30,24,6,2359,78.6,iowa,3234
2018,23,South Dakota St.,29,23,6,2275,78.4,south dakota st.,3355
2018,24,Lamar University,27,21,6,2107,78,american university,3110
2018,25,Tennessee,30,24,6,2340,78,tennessee,3397
2018,26,Northern Ill.,28,15,13,2182,77.9,northern ill.,3296
2018,27,Texas A&M,31,23,8,2413,77.8,texas a&m,3401
2018,28,FGCU,31,27,4,2408,77.7,fgcu,3195
2018,29,Brown,25,15,10,1933,77.3,brown,3135
2018,30,Louisville,31,29,2,2393,77.2,louisville,3257
2018,31,Buffalo,28,24,4,2159,77.1,buffalo,3138
2018,32,South Carolina,29,23,6,2229,76.9,south carolina,3376
2018,33,Michigan,30,22,8,2286,76.2,michigan,3276
2018,34,Western Ky.,28,21,7,2125,75.9,western ky.,3443
2018,35,Pacific,30,14,16,2272,75.7,pacific,3334
2018,36,South Fla.,30,24,6,2271,75.7,south fla.,3378
2018,37,Oklahoma,29,16,13,2195,75.7,oklahoma,3328
2018,38,UCLA,29,23,6,2188,75.4,ucla,3417
2018,39,Weber St.,28,19,9,2111,75.4,weber st.,3451
2018,40,South Dakota,29,24,5,2180,75.2,south dakota,3377
2018,41,Michigan St.,30,17,13,2245,74.8,michigan st.,3277
2018,42,TCU,29,18,11,2169,74.8,tcu,3395
2018,43,Idaho,28,16,12,2094,74.8,idaho,3225
2018,44,Dayton,27,22,5,2015,74.6,dayton,3173
2018,45,Oregon St.,29,23,6,2156,74.3,oregon st.,3333
2018,46,Houston,30,20,10,2229,74.3,houston,3222
2018,47,Wright St.,30,21,9,2225,74.2,wright st.,3460
2018,48,West Virginia,30,20,10,2223,74.1,west virginia,3452
2018,49,Syracuse,30,22,8,2209,73.6,syracuse,3393
2018,50,Elon,28,21,7,2058,73.5,elon,3189
2018,51,UAB,27,22,5,1982,73.4,uab,3412
2018,52,UC Davis,28,24,4,2054,73.4,uc davis,3413
2018,53,UT Martin,31,18,13,2270,73.2,ut martin,3404
2018,54,Virginia Tech,30,18,12,2193,73.1,virginia tech,3439
2018,55,Saint Louis,30,16,14,2192,73.1,saint louis,3387
2018,56,SFA,28,23,5,2045,73,utsa,3427
2018,57,North Carolina,31,15,16,2263,73,north carolina,3314
2018,58,Cal Poly,27,16,11,1955,72.4,cal poly,3142
2018,59,Jackson St.,26,14,12,1880,72.3,jackson st.,3238
2018,60,UC Irvine,29,17,12,2093,72.2,uc irvine,3414
2018,61,Gonzaga,29,24,5,2092,72.1,gonzaga,3211
2018,62,Sacramento St.,28,7,21,2013,71.9,sacramento st.,3170
2018,63,Morehead St.,32,21,11,2297,71.8,morehead st.,3287
2018,64,Quinnipiac,29,24,5,2078,71.7,quinnipiac,3346
2018,65,Utah,30,17,13,2144,71.5,utah,3428
2018,66,Prairie View,28,14,14,2001,71.5,prairie view,3341
2018,67,Texas St.,28,20,8,1995,71.3,texas st.,3402
2018,68,Miami (FL),29,20,9,2065,71.2,miami (fl),3274
2018,69,Saint Mary's (CA),29,20,9,2064,71.2,saint mary's (ca),3388
2018,70,Portland St.,28,16,12,1983,70.8,portland st.,3340
2018,71,Oakland,29,14,15,2052,70.8,oakland,3324
2018,72,Missouri,30,24,6,2121,70.7,missouri,3281
2018,73,Mercer,30,28,2,2120,70.7,mercer,3273
2018,74,IUPUI,29,21,8,2049,70.7,iupui,3237
2018,75,Denver,29,16,13,2047,70.6,denver,3176
2018,75,Duquesne,29,23,6,2047,70.6,duquesne,3182
2018,77,Miami (OH),28,19,9,1976,70.6,miami (oh),3275
2018,78,Abilene Christian,27,15,12,1903,70.5,abilene christian,3101
2018,79,Colorado,30,15,15,2109,70.3,colorado,3160
2018,80,Missouri St.,28,18,10,1965,70.2,missouri st.,3283
2018,81,Indiana,30,17,13,2103,70.1,indiana,3231
2018,82,Murray St.,30,11,19,2102,70.1,murray st.,3293
2018,83,Idaho St.,28,18,10,1961,70,idaho st.,3226
2018,84,Duke,29,22,7,2029,70,duke,3181
2018,85,Fla. Atlantic,26,13,13,1819,70,fla. atlantic,3194
2018,86,Nebraska,29,20,9,2024,69.8,nebraska,3304
2018,87,Creighton,28,17,11,1953,69.8,creighton,3166
2018,88,Boise St.,28,19,9,1951,69.7,boise st.,3129
2018,89,Western Mich.,29,15,14,2018,69.6,western mich.,3444
2018,90,George Mason,31,23,8,2156,69.5,george mason,3206
2018,91,San Jose St.,28,7,21,1941,69.3,san jose st.,3363
2018,92,Albany (NY),29,23,6,2010,69.3,albany (ny),3107
2018,93,Eastern Mich.,28,10,18,1939,69.3,eastern mich.,3185
2018,94,Loyola Marymount,29,19,10,2007,69.2,loyola marymount,3258
2018,95,Vanderbilt,31,7,24,2142,69.1,vanderbilt,3435
2018,96,California,29,20,9,2002,69,california,3143
2018,97,Penn St.,31,16,15,2137,68.9,penn st.,3336
2018,98,Northern Ariz.,28,7,21,1930,68.9,northern ariz.,3319
2018,99,Georgia,29,24,5,1998,68.9,georgia,3208
2018,100,Arizona St.,31,20,11,2133,68.8,arizona st.,3113
2018,101,Yale,25,15,10,1720,68.8,yale,3463
2018,102,Northern Colo.,28,22,6,1924,68.7,northern colo.,3294
2018,103,Stanford,29,20,9,1991,68.7,stanford,3390
2018,104,Oral Roberts,28,16,12,1921,68.6,oral roberts,3331
2018,105,San Francisco,29,15,14,1988,68.6,san francisco,3362
2018,106,Nevada,28,13,15,1919,68.5,nevada,3305
2018,107,ETSU,30,19,11,2056,68.5,etsu,3190
2018,108,Harvard,25,16,9,1712,68.5,harvard,3217
2018,109,Marist,30,18,12,2053,68.4,marist,3265
2018,110,Kentucky,31,15,16,2120,68.4,kentucky,3246
2018,111,UMKC,28,10,18,1910,68.2,umkc,3282
2018,112,Seattle U,28,14,14,1906,68.1,seattle,3370
2018,113,Jacksonville,29,22,7,1973,68,jacksonville,3239
2018,114,Massachusetts,30,14,16,2041,68,massachusetts,3269
2018,114,Southern California,30,20,10,2041,68,southern california,3425
2018,116,Kansas St.,29,15,14,1969,67.9,kansas st.,3243
2018,116,Cleveland St.,29,19,10,1969,67.9,cleveland st.,3156
2018,118,NC State,30,23,7,2034,67.8,nc state,3301
2018,119,Cincinnati,29,18,11,1965,67.8,cincinnati,3153
2018,120,UNLV,28,18,10,1895,67.7,unlv,3424
2018,121,Tennessee St.,27,6,21,1826,67.6,tennessee st.,3398
2018,122,Alabama,30,17,13,2028,67.6,alabama,3104
2018,123,Princeton,25,20,5,1688,67.5,princeton,3343
2018,124,Toledo,29,17,12,1956,67.4,toledo,3405
2018,125,Penn,25,18,7,1685,67.4,penn,3335
2018,126,North Dakota St.,28,9,19,1887,67.4,north dakota st.,3295
2018,127,N.C. A&T,28,20,8,1886,67.4,n.c. a&t,3299
2018,128,Arkansas,31,13,18,2084,67.2,arkansas,3116
2018,129,Villanova,29,22,7,1949,67.2,villanova,3437
2018,130,Seton Hall,29,15,14,1946,67.1,seton hall,3371
2018,131,Washington,29,7,22,1944,67,washington,3449
2018,131,Pepperdine,29,10,19,1944,67,pepperdine,3337
2018,133,Ohio,28,15,13,1875,67,ohio,3325
2018,134,Montana St.,28,15,13,1871,66.8,montana st.,3286
2018,135,Louisiana Tech,29,19,10,1937,66.8,louisiana tech,3256
2018,136,Iowa St.,29,13,16,1935,66.7,iowa st.,3235
2018,137,St. John's (NY),29,16,13,1933,66.7,st. john's (ny),3385
2018,138,New Mexico St.,27,16,11,1798,66.6,new mexico st.,3308
2018,139,BYU,30,16,14,1997,66.6,byu,3140
2018,140,Valparaiso,28,12,16,1863,66.5,valparaiso,3434
2018,141,South Ala.,28,17,11,1861,66.5,south ala.,3375
2018,142,Eastern Wash.,29,16,13,1927,66.4,eastern wash.,3186
2018,143,William & Mary,28,16,12,1860,66.4,william & mary,3456
2018,143,Southern Miss.,28,15,13,1860,66.4,southern miss.,3379
2018,145,Georgia Tech,31,18,13,2059,66.4,georgia tech,3210
2018,146,Wake Forest,30,14,16,1992,66.4,wake forest,3448
2018,147,UC Santa Barbara,28,12,16,1856,66.3,uc santa barbara,3364
2018,148,Bradley,28,12,16,1854,66.2,bradley,3133
2018,148,Grambling,28,15,13,1854,66.2,grambling,3212
2018,150,Delaware,28,17,11,1853,66.2,delaware,3174
2018,151,LSU,27,19,8,1786,66.1,lsu,3261
2018,152,New Orleans,29,15,14,1916,66.1,new orleans,3309
2018,153,Purdue,31,18,13,2048,66.1,purdue,3345
2018,154,North Dakota,28,12,16,1847,66,north dakota,3315
2018,155,Washington St.,30,10,20,1978,65.9,washington st.,3450
2018,156,Wichita St.,30,14,16,1976,65.9,wichita st.,3455
2018,157,Saint Joseph's,29,16,13,1910,65.9,saint joseph's,3386
2018,158,Arkansas St.,28,14,14,1844,65.9,arkansas st.,3117
2018,159,Temple,29,11,18,1909,65.8,temple,3396
2018,160,Rice,27,19,8,1777,65.8,rice,3349
2018,161,Charlotte,28,13,15,1842,65.8,charlotte,3150
2018,162,Niagara,30,13,17,1973,65.8,niagara,3310
2018,163,Maine,29,20,9,1904,65.7,maine,3263
2018,164,Southern U.,26,14,12,1706,65.6,southern u.,3380
2018,165,Milwaukee,30,20,10,1968,65.6,milwaukee,3454
2018,165,Florida,30,11,19,1968,65.6,florida,3196
2018,167,Ole Miss,31,12,19,2033,65.6,ole miss,3279
2018,168,Richmond,30,14,16,1966,65.5,richmond,3350
2018,169,Navy,29,23,6,1900,65.5,navy,3298
2018,170,High Point,28,16,12,1832,65.4,high point,3219
2018,171,Green Bay,29,26,3,1897,65.4,green bay,3453
2018,172,Fresno St.,28,16,12,1830,65.4,fresno st.,3201
2018,173,USC Upstate,29,11,18,1895,65.3,usc upstate,3367
2018,174,UC Riverside,29,8,21,1893,65.3,uc riverside,3415
2018,175,Rutgers,31,20,11,2021,65.2,rutgers,3353
2018,176,East Carolina,29,15,14,1889,65.1,east carolina,3187
2018,177,SIUE,30,17,13,1952,65.1,siena,3373
2018,178,Youngstown St.,29,15,14,1886,65,youngstown st.,3464
2018,178,American,29,23,6,1886,65,american,3110
2018,180,Nicholls St.,28,15,13,1819,65,nicholls st.,3311
2018,181,Coastal Caro.,28,15,13,1818,64.9,coastal caro.,3157
2018,182,Alcorn,28,11,17,1817,64.9,alcorn,3108
2018,183,Howard,29,12,17,1881,64.9,howard,3224
2018,184,Furman,30,17,13,1944,64.8,furman,3202
2018,185,CSUN,29,15,14,1877,64.7,lsu,3261
2018,185,Marshall,29,9,20,1877,64.7,marshall,3267
2018,187,Dartmouth,25,14,11,1617,64.7,dartmouth,3171
2018,188,Akron,28,8,20,1809,64.6,akron,3103
2018,189,Stetson,30,17,13,1938,64.6,stetson,3391
2018,190,Georgetown,28,14,14,1808,64.6,georgetown,3207
2018,191,Hartford,29,17,12,1872,64.6,hartford,3216
2018,192,San Diego St.,28,11,17,1806,64.5,san diego st.,3361
2018,193,Butler,30,14,16,1931,64.4,butler,3139
2018,194,Liberty,29,20,9,1865,64.3,liberty,3251
2018,195,Texas Southern,28,18,10,1800,64.3,texas southern,3411
2018,196,Hampton,29,16,13,1864,64.3,hampton,3214
2018,197,Bowling Green,28,11,17,1799,64.3,bowling green,3132
2018,198,San Diego,30,16,14,1926,64.2,san diego,3360
2018,199,Mt. St. Mary's,27,9,18,1731,64.1,mt. st. mary's,3291
2018,200,Bethune-Cookman,28,23,5,1794,64.1,bethune-cookman,3126
2018,200,UTEP,28,15,13,1794,64.1,utep,3431
2018,200,Southern Ill.,28,15,13,1794,64.1,southern ill.,3356
2018,203,McNeese,28,12,16,1793,64,mcneese st,3270
2018,204,Drexel,29,23,6,1856,64,drexel,3180
2018,204,James Madison,28,19,9,1792,64,james madison,3241
2018,204,Omaha,27,12,15,1728,64,omaha,3303
2018,207,Holy Cross,29,12,17,1855,64,holy cross,3221
2018,208,Portland,30,7,23,1915,63.8,portland,3339
2018,209,Towson,28,9,19,1787,63.8,towson,3406
2018,210,UNCG,30,13,17,1907,63.6,unc,3314
2018,211,Bucknell,29,21,8,1843,63.6,bucknell,3137
2018,212,Binghamton,29,19,10,1841,63.5,binghamton,3127
2018,213,Grand Canyon,27,14,13,1709,63.3,grand canyon,3213
2018,214,Hawaii,28,12,16,1772,63.3,hawaii,3218
2018,215,UNI,28,16,12,1770,63.2,uni,3320
2018,215,Montana,28,13,15,1770,63.2,montana,3285
2018,215,FIU,28,7,21,1770,63.2,fiu,3198
2018,215,UMES,28,10,18,1770,63.2,umes,3271
2018,219,Texas Tech,29,7,22,1833,63.2,texas tech,3403
2018,220,Austin Peay,30,16,14,1896,63.2,austin peay,3122
2018,221,UT Arlington,28,18,10,1768,63.1,ut arlington,3426
2018,222,Long Beach St.,29,7,22,1830,63.1,long beach st.,3253
2018,222,Lipscomb,29,11,18,1830,63.1,lipscomb,3252
2018,224,Davidson,30,12,18,1893,63.1,davidson,3172
2018,225,Northeastern,28,15,13,1766,63.1,northeastern,3318
2018,225,Georgia St.,28,8,20,1766,63.1,georgia st.,3209
2018,227,St. Bonaventure,30,8,22,1891,63,st. bonaventure,3382
2018,228,Kent St.,29,12,17,1827,63,kent st.,3245
2018,229,Stony Brook,29,18,11,1823,62.9,stony brook,3392
2018,229,N.C. Central,29,9,20,1823,62.9,n.c. central,3300
2018,231,Sacred Heart,28,12,16,1760,62.9,sacred heart,3357
2018,232,Southeast Mo. St.,31,14,17,1948,62.8,southeast mo. st.,3369
2018,233,Rider,29,13,16,1820,62.8,rider,3351
2018,234,Virginia,30,18,12,1879,62.6,virginia,3438
2018,235,Tulane,29,13,16,1816,62.6,tulane,3408
2018,236,Central Ark.,28,20,8,1753,62.6,central ark.,3146
2018,237,Wofford,30,10,20,1878,62.6,wofford,3459
2018,238,Norfolk St.,28,18,10,1750,62.5,norfolk st.,3313
2018,238,Southeastern La.,28,8,20,1750,62.5,southeastern la.,3368
2018,240,St. Francis Brooklyn,27,12,15,1687,62.5,st. francis brooklyn,3383
2018,241,Auburn,29,14,15,1810,62.4,auburn,3120
2018,242,Robert Morris,27,21,6,1684,62.4,robert morris,3352
2018,243,Utah Valley,28,11,17,1746,62.4,utah valley,3430
2018,244,Gardner-Webb,29,18,11,1806,62.3,gardner-webb,3205
2018,245,UNC Asheville,28,14,14,1741,62.2,unc asheville,3421
2018,246,UTRGV,28,14,14,1740,62.1,utrgv,3410
2018,247,North Florida,29,12,17,1799,62,north florida,3316
2018,248,Kansas,29,12,17,1798,62,kansas,3242
2018,248,Bryant,27,9,18,1674,62,bryant,3136
2018,250,Morgan St.,29,15,14,1797,62,morgan st.,3288
2018,251,Charleston So.,27,9,18,1670,61.9,charleston so.,3149
2018,252,Fairleigh Dickinson,28,15,13,1731,61.8,fairleigh dickinson,3192
2018,253,Northwestern,32,12,20,1978,61.8,northwestern,3321
2018,254,Columbia,27,8,19,1668,61.8,columbia,3162
2018,255,Jacksonville St.,30,19,11,1852,61.7,jacksonville st.,3240
2018,256,Houston Baptist,27,10,17,1664,61.6,houston baptist,3223
2018,257,Lehigh,29,15,14,1787,61.6,lehigh,3250
2018,258,North Texas,26,15,11,1602,61.6,north texas,3317
2018,259,Radford,28,21,7,1725,61.6,radford,3347
2018,260,Colorado St.,29,19,10,1783,61.5,colorado st.,3161
2018,261,Fordham,30,22,8,1842,61.4,fordham,3200
2018,262,A&M-Corpus Christi,28,17,11,1719,61.4,a&m-corpus chris,3394
2018,263,Illinois,31,9,22,1902,61.4,illinois,3228
2018,264,Army West Point,29,16,13,1778,61.3,armstrong,3118
2018,265,Siena,29,16,13,1776,61.2,siena,3373
2018,266,UNCW,28,11,17,1704,60.9,unc,3314
2018,266,Wyoming,28,20,8,1704,60.9,wyoming,3461
2018,268,Wisconsin,30,9,21,1819,60.6,wisconsin,3458
2018,269,Tulsa,29,9,20,1755,60.5,tulsa,3409
2018,270,Evansville,28,3,25,1694,60.5,evansville,3191
2018,271,VCU,29,7,22,1749,60.3,vcu,3433
2018,272,Tennessee Tech,29,7,22,1746,60.2,tennessee tech,3399
2018,273,UTSA,27,8,19,1621,60,utsa,3427
2018,274,Hofstra,28,11,17,1679,60,hofstra,3220
2018,275,George Washington,29,16,13,1738,59.9,george washington,3203
2018,276,Cal St. Fullerton,28,8,20,1678,59.9,cal st. fullerton,3168
2018,277,New Hampshire,29,18,11,1736,59.9,new hampshire,3306
2018,278,Louisiana,29,15,14,1733,59.8,se louisiana,3368
2018,278,Detroit Mercy,29,2,27,1733,59.8,detroit mercy,3178
2018,280,Loyola Maryland,29,9,20,1732,59.7,loyola maryland,3259
2018,281,CSU Bakersfield,27,16,11,1606,59.5,cs bakersfield,3167
2018,282,Providence,30,10,20,1783,59.4,providence,3344
2018,283,Little Rock,28,19,9,1662,59.4,little rock,3114
2018,284,Presbyterian,28,11,17,1661,59.3,presbyterian,3342
2018,285,Utah St.,28,7,21,1660,59.3,utah st.,3429
2018,286,Pittsburgh,30,10,20,1778,59.3,pittsburgh,3338
2018,287,UCF,29,20,9,1717,59.2,ucf,3416
2018,287,Xavier,29,10,19,1717,59.2,xavier,3462
2018,289,Southern Utah,28,3,25,1656,59.1,southern utah,3381
2018,290,Indiana St.,28,11,17,1655,59.1,indiana st.,3232
2018,291,Chattanooga,29,17,12,1714,59.1,chattanooga,3151
2018,292,South Carolina St.,28,11,17,1648,58.9,south carolina st.,3354
2018,293,Florida A&M,29,6,23,1704,58.8,florida a&m,3197
2018,294,Memphis,29,10,19,1703,58.7,memphis,3272
2018,295,UMass Lowell,30,4,26,1761,58.7,umass lowell,3262
2018,296,Eastern Ill.,29,3,26,1702,58.7,eastern ill.,3183
2018,297,Boston U.,28,10,18,1643,58.7,boston u.,3131
2018,298,Central Conn. St.,27,6,21,1584,58.7,central conn. st.,3148
2018,299,Manhattan,30,13,17,1758,58.6,manhattan,3264
2018,300,Samford,30,15,15,1751,58.4,samford,3359
2018,301,Delaware St.,29,6,23,1688,58.2,delaware st.,3175
2018,302,Boston College,30,7,23,1745,58.2,boston college,3130
2018,303,Arizona,30,6,24,1738,57.9,arizona,3112
2018,304,Northern Ky.,29,8,21,1676,57.8,northern ky.,3297
2018,305,Ill.-Chicago,29,8,21,1674,57.7,ill.-chicago,3227
2018,306,Middle Tenn.,28,17,11,1614,57.6,middle tenn.,3292
2018,307,Rhode Island,30,3,27,1728,57.6,rhode island,3348
2018,308,La Salle,30,8,22,1725,57.5,la salle,3247
2018,309,NJIT,29,4,25,1664,57.4,njit,3312
2018,310,Mississippi Val.,29,2,27,1662,57.3,mississippi val.,3290
2018,310,Vermont,29,8,21,1662,57.3,vermont,3436
2018,312,Northwestern St.,28,7,21,1603,57.3,northwestern st.,3322
2018,313,Col. of Charleston,28,6,22,1601,57.2,col. of charleston,3158
2018,314,Appalachian St.,28,7,21,1596,57,appalachian st.,3111
2018,315,La.-Monroe,28,4,24,1594,56.9,la.-monroe,3419
2018,316,Fort Wayne,27,4,23,1537,56.9,iupu-fort wayne,3236
2018,316,Eastern Ky.,27,8,19,1537,56.9,eastern ky.,3184
2018,318,Kennesaw St.,25,7,18,1421,56.8,kennesaw st.,3244
2018,319,Campbell,28,15,13,1591,56.8,campbell,3144
2018,320,Colgate,29,7,22,1643,56.7,colgate,3159
2018,321,Sam Houston St.,26,4,22,1468,56.5,sam houston st.,3358
2018,322,Alabama A&M,28,11,17,1578,56.4,alabama a&m,3105
2018,323,Fairfield,29,13,16,1622,55.9,fairfield,3193
2018,324,Ark.-Pine Bluff,27,7,20,1507,55.8,ark.-pine bluff,3115
2018,325,Coppin St.,28,6,22,1562,55.8,coppin st.,3164
2018,326,Lafayette,28,10,18,1555,55.5,lafayette,3248
2018,327,Canisius,30,10,20,1666,55.5,canisius,3145
2018,328,Wagner,27,6,21,1498,55.5,wagner,3447
2018,329,Savannah St.,28,4,24,1553,55.5,savannah st.,3366
2018,330,Monmouth,30,10,20,1663,55.4,monmouth,3284
2018,331,SMU,29,10,19,1607,55.4,smu,3374
2018,332,Cornell,25,6,19,1383,55.3,cornell,3165
2018,333,LIU Brooklyn,27,10,17,1493,55.3,liu brooklyn,3254
2018,334,Air Force,28,4,24,1548,55.3,air force,3102
2018,335,Ga. Southern,28,5,23,1544,55.1,ga. southern,3204
2018,336,Old Dominion,29,8,21,1597,55.1,old dominion,3330
2018,337,Western Caro.,30,5,25,1648,54.9,western caro.,3441
2018,338,Alabama St.,28,8,20,1535,54.8,alabama st.,3106
2018,339,Loyola Chicago,28,7,21,1517,54.2,loyola chicago,3260
2018,339,Illinois St.,28,13,15,1517,54.2,illinois st.,3229
2018,341,Longwood,28,6,22,1496,53.4,longwood,3255
2018,342,UMBC,30,5,25,1575,52.5,umbc,3420
2018,343,Iona,30,2,28,1571,52.4,iona,3233
2018,344,Saint Peter's,30,4,26,1563,52.1,saint peter's,3389
2018,345,Santa Clara,30,9,21,1562,52.1,santa clara,3365
2018,346,Incarnate Word,28,4,24,1441,51.5,incarnate word,3230
2018,347,Clemson,30,11,19,1515,50.5,clemson,3155
2018,348,Chicago St.,28,1,27,1412,50.4,chicago st.,3152
2018,349,Winthrop,28,3,25,1407,50,winthrop,3457.3